阿德丽安娜迪亚兹	a de li an na di ya zi
阿尔瓦罗罗伯勒斯	a er wa luo luo bo le si
安东卡尔伯格	an dong ka er bo ge
安宰贤	an zai xian
奥拉万帕拉南	ao la wan pa la nan
奥玛阿萨尔	ao ma a sa er
奥恰洛夫	ao qia luo fu
贝内迪克特杜达	bei nei di ke te du da
伯纳黛特斯佐科斯	bo na dai te si zuo ke si
陈幸同	chen xing tong
达科约奇克	da ke yue qi ke
杜凯琹	du kai qin
法尔克	fa er ke
高承睿	gao cheng rui
高桥布鲁娜	gao qiao bu lu na
汉娜高达	han na gao da
户上隼辅	hu shang sun fu
黄镇廷	huang zhen ting
吉川真晴	ji chuan zhen qing
基里尔格拉斯门科	ji li er ge la si men ke
简彤娟	jian tong juan
金娜英	jin na ying
夸德里阿鲁纳	kua de li a lu na
利亚姆皮切福德	li ya mu pi qie fu de
李元璋	li yuan zhang
梁靖崑	liang jing kun
琳达博格斯特隆	lin da bo ge si te long
林高远	lin gao yuan
林诗栋	lin shi dong
林文政	lin wen zheng
林昀儒	lin yun ru
林钟勋	lin zhong xun
刘扬子	liu yang zi
玛尼卡巴特拉	ma ni ka ba te la
木原美悠	mu yuan mei you
娜塔莉亚巴约	na ta li ya ba yue
帕特里克弗朗西斯卡	pa te li ke fu lang xi si ka
平野美宇	ping ye mei yu
普利蒂卡帕瓦德	pu li di ka pa wa de
邱党	qiu dang
莎贝拉萨马拉	sha bei la sa ma la
邵杰妮	shao jie ni
松岛辉空	song dao hui kong
孙颖莎	sun ying sha
特鲁斯莫雷加德	te lu si mo lei jia de
田志希	tian zhi xi
王艾米	wang ai mi
王楚钦	wang chu qin
王曼昱	wang man yu
王艺迪	wang yi di
西蒙高茨	xi meng gao ci
徐孝元	xu xiao yuan
徐瑛彬	xu ying bin
杨晓馨	yang xiao xin
伊利	yi li
伊藤美诚	yi teng mei cheng
袁嘉楠	yuan jia nan
约纳坦格罗特	yue na tan ge luo te
张本美和	zhang ben mei he
张本智和	zhang ben zhi he
张墨	zhang mo
赵大成	zhao da cheng
郑怡静	zheng yi jing
朱芊曦	zhu qian xi
朱雨玲	zhu yu ling