阿瓦布照管人	a wa bu zhao guan ren
艾德嘉觉醒	ai de jia jue xing
艾德嘉马可夫之棺	ai de jia ma ke fu zhi guan
奥莉薇亚的喜娘	ao li wei ya di xi niang
孢背狼	bao bei lang
暴食宾客	bao shi bin ke
暴躁独行客	bao zao du xing ke
庇护林枝	bi hu lin zhi
庇护育篮	bi hu yu lan
必中一击	bi zhong yi ji
编花巧匠	bian hua qiao jiang
播望苍鹭	bo wang cang lu
怖光巨蟹	bu guang ju xie
不洁司仪	bu jie si yi
怖狼脉崇乱兽	bu lang mai chong luan shou
不死管家	bu si guan jia
不息恶意	bu xi e yi
惨怖仪式	can bu yi shi
残酷见证鸟	can ku jian zheng niao
糙节林行妖	cao jie lin xing yao
缠缚游魂	chan fu you hun
超凡救援	chao fan jiu yuan
巢心祭师	chao xin ji shi
成婚佳讯	cheng hun jia xun
成婚庆典	cheng hun qing dian
成形野地	cheng xing ye di
成长首领	cheng zhang shou ling
传教牧师	chuan jiao mu shi
穿心明光	chuan xin ming guang
刺藤甲	ci teng jia
刺藤亚龙	ci teng ya long
慈祥先祖	ci xiang xian zu
村庄先锋	cun zhuang xian feng
灯浮升空	deng fu sheng kong
抵抗小队	di kang xiao dui
电流幻视师	dian liu huan shi shi
调查员日志	diao cha yuan ri zhi
钉板窗户	ding ban chuang hu
毒蕈林地	du xun lin di
多萝霞的报偿	duo luo xia de bao chang
堕落刈客	duo luo yi ke
夺念食尸鬼	duo nian shi shi gui
多色	duo se
恶毒侵客	e du qin ke
恶魔交易	e mo jiao yi
恶兆塑像	e zhao su xiang
恩资森盾击手	en zi sen dun ji shou
伐肯纳贵客	fa ken na gui ke
伐肯纳先人	fa ken na xian ren
绯红新娘奥莉薇亚	fei hong xin niang ao li wei ya
非请莫入	fei qing mo ru
飞逝精怪	fei shi jing guai
坟墓寒息	fen mu han xi
愤怒脱囚兽	fen nu tuo qiu shou
风化侵蚀	feng hua qin shi
风蚀海岸	feng shi hai an
缝组助手	feng zu zhu shou
腐潮巨罡兽	fu chao ju gang shou
浮灯游魂	fu deng you hun
符锢狼	fu gu lang
缚密精怪	fu mi jing guai
腐蚀蝓怪陀袭力	fu shi yu guai tuo xi li
覆铁精怪	fu tie jing guai
复组标本	fu zu biao ben
钩手海员	gou shou hai yuan
鬼魅拟装	gui mei ni zhuang
鬼雾诱灵	gui wu you ling
海岛	hai dao
海底赠礼	hai di zeng li
好斗宾客	hao dou bin ke
好客诅咒	hao ke zu zhou
豪肯视像	hao ken shi xiang
好奇猫心	hao qi mao xin
嚎群笛手	hao qun di shou
嚎群复仇者	hao qun fu chou zhe
荷拉娜与阿雷娜伴侣	he la na yu a lei na ban lv
亨莉卡多纳提	heng li ka duo na ti
护根	hu gen
花簇狼人	hua cu lang ren
幻根瀑布	huan gen pu bu
唤群幼狼	huan qun you lang
辉光华彩	hui guang hua cai
辉光束缚	hui guang shu fu
辉煌日出	hui huang ri chu
婚礼警卫	hun li jing wei
婚礼破坏兽	hun li po huai shou
婚礼请柬	hun li qing jian
集电尸嵌	ji dian shi qian
极恶刺蝎	ji e ci xie
饥饿脊狼	ji e ji lang
寄生之攫	ji sheng zhi jue
祭仪小刀	ji yi xiao dao
尖刺链锯	jian ci lian ju
坚定意志	jian ding yi zhi
尖鸣妖群	jian ming yao qun
尖牙赋礼	jian ya fu li
降罪判决	jiang zui pan jue
教区精兵学员	jiao qu jing bing xue yuan
揭物巨眼	jie wu ju yan
惊怖狼人	jing bu lang ren
惊慌观客	jing huang guan ke
镜廊拟妖	jing lang ni yao
净圣	jing sheng
拘禁牢环	ju jin lao huan
巨狼扑袭	ju lang pu xi
锯轮射手	ju lun she shou
巨弩持兽	ju nu chi shou
巨弩守卫	ju nu shou wei
骏鹭骑手	jun lu qi shou
凯蒂妲破晓之威	kai di da po xiao zhi wei
凯锡革狼骑兵	kai xi ge lang qi bing
凯锡革喷焰师	kai xi ge pen yan shi
可怖控偶师	ke bu kong ou shi
可雕学徒	ke diao xue tu
渴求发现	ke qiu fa xian
咳笑魁首	ke xiao kui shou
可憎巫婆	ke zeng wu po
恐怖玩具屋	kong bu wan ju wu
恐惧神游	kong ju shen you
恐惧死亡	kong ju si wang
控念吸血鬼	kong nian xi xue gui
空圆地捕猎兽	kong yuan di bu lie shou
狂热魔鬼	kuang re mo gui
褴褛隐士	lan lv yin shi
狼群幼子	lang qun you zi
狼族遭黜人	lang zu zao chu ren
老鲁斯登	lao lu si deng
力量陡增	li liang dou zeng
利爪碎身	li zhua sui shen
炼金术士的计策	lian jin shu shi de ji ce
炼金术士回收咒	lian jin shu shi hui shou zhou
炼狱预言师亨莉卡	lian yu yu yan shi heng li ka
烈毒蝎	lie du xie
裂钩劫狼	lie gou jie lang
鲁莽冲动	lu mang chong dong
卢诺溪堡	lu nuo xi bao
鹭翼骑兵	lu yi qi bing
鹭佑游魂	lu you you hun
马可夫报偿	ma ke fu bao chang
马可夫涤净师	ma ke fu di jing shi
马可夫圆舞者	ma ke fu yuan wu zhe
蛮野群伴	man ye qun ban
密魂谜板	mi hun mi ban
迷人求婚者	mi ren qiu hun zhe
蜜月柩车	mi yue jiu che
瞄准头部	miao zhun tou bu
民兵召集人	min bing zhao ji ren
墓地渎圣尸	mu di du sheng shi
墓地裂肢兵	mu di lie zhi bing
墓地燃灯灵	mu di ran deng ling
墓地守门者	mu di shou men zhe
墓地卫护兵	mu di wei hu bing
墓地游掠狼	mu di you lue lang
孽恶蜘蛛	nie e zhi zhu
孽物方阵兵团	nie wu fang zhen bing tuan
农庄新兵	nong zhuang xin bing
女巫蛛网	nv wu zhu wang
欧雷巴救星	ou lei ba jiu xing
欧雷巴卫士	ou lei ba wei shi
抛石队长	pao shi dui zhang
抛石炮灰	pao shi pao hui
咆哮狼	pao xiao lang
培护巨像	pei hu ju xiang
配装天使	pei zhuang tian shi
疲惫遭囚犯	pi bei zao qiu fan
劈裂烈火	pi lie lie huo
拼死效命	pin si xiao ming
拼装匍尸	pin zhuang pu shi
拼组枪骑手	pin zu qiang qi shou
平原	ping yuan
破碎圣所	po sui sheng suo
破晓战士	po xiao zhan shi
潜水尸嵌	qian shui shi qian
切分	qie fen
亲睹未来	qin du wei lai
情急农夫	qing ji nong fu
取回旧物	qu hui jiu wu
全能噬蛙葛诺克	quan neng shi wa ge nuo ke
全数冲尽	quan shu chong jin
染虫狼人	ran chong lang ren
扰神妙法	rao shen miao fa
日落隘口	ri luo ai kou
融血喷泉	rong xue pen quan
荣耀传家宝	rong yao chuan jia bao
蠕爬侵扰	ru pa qin rao
塞贺入土妖	sai he ru tu yao
瑟班大尸鬼	se ban da shi gui
瑟班守护者莎利雅	se ban shou hu zhe sha li ya
闪电狼	shan dian lang
山脉	shan mai
蛇身伏击	she shen fu ji
神器	shen qi
神射手学徒	shen she shou xue tu
深挖探寻	shen wa tan xun
深渊之主寇瑟斯	shen yuan zhi zhu kou se si
生辉巨蛇	sheng hui ju she
生辉奇卵	sheng hui qi luan
圣魂萦绕	sheng hun ying rao
盛装茜卓	sheng zhuang qian zhuo
史顿襄式抗暴	shi dun xiang shi kang bao
时来运转	shi lai yun zhuan
逝者明灯	shi zhe ming deng
受福者之声	shou fu zhe zhi sheng
受惊村民	shou jing cun min
受难先知伊如	shou nan xian zhi yi ru
受启创意	shou qi chuang yi
受诅血咒的欧吉克	shou zu xue zhou de ou ji ke
树冠压袭	shu guan ya xi
树林	shu lin
曙鹿集殉道者凯蒂妲	shu lu ji xun dao zhe kai di da
曙鹿集游魂	shu lu ji you hun
曙鹿群信徒	shu lu qun xin tu
双刃游魂	shuang ren you hun
双刃祝愿	shuang ren zhu yuan
水沟捷径	shui gou jie jing
水沟匿魂	shui gou ni hun
死冥双身	si ming shuang shen
搜海精怪	sou hai jing guai
塑魔残虐者	su mo can nue zhe
碎船惊惧兽	sui chuan jing ju shou
锁梦游魂	suo meng you hun
苔墓千足虫	tai mu qian zu chong
提灯闪光	ti deng shan guang
天使之拳托亨斯	tian shi zhi quan tuo heng si
头颅尸嵌	tou lu shi qian
吞噬浪潮	tun shi lang chao
顽皮猫魂	wan pi mao hun
沃达连邸	wo da lian di
沃达连品血客	wo da lian pin xue ke
沃达连血育师	wo da lian xue yu shi
沃文森贝西摩斯	wo wen sen bei xi mo si
沃文森异兽	wo wen sen yi shou
无辜旅人	wu gu lv ren
污劣大群	wu lie da qun
无头骑手	wu tou qi shou
无休觅血客	wu xiu mi xue ke
武装护教军	wu zhuang hu jiao jun
席嘉妲神圣武士	xi jia da shen sheng wu shi
席嘉妲遭缚	xi jia da zao fu
席嘉妲召唤	xi jia da zhao huan
喜庆终结	xi qing zhong jie
吸收菁华	xi shou jing hua
吸血鬼复仇	xi xue gui fu chou
吸血鬼克星	xi xue gui ke xing
吸血鬼之吻	xi xue gui zhi wen
细语法师	xi yu fa shi
险峻路途	xian jun lu tu
鲜血催眠师	xian xue cui mian shi
鲜血侍从	xian xue shi cong
先祖怒火	xian zu nu huo
先祖之拥	xian zu zhi yong
飨惧恶魔	xiang ju e mo
橡影潜伏客	xiang ying qian fu ke
邪气伴娘安姬	xie qi ban niang an ji
新郎礼服	xin lang li fu
新娘婚纱	xin niang hun sha
星散思绪	xing san si xu
凶暴报偿	xiong bao bao chang
休眠古林地	xiu mian gu lin di
绚烂复生	xuan lan fu sheng
血瓣主祭	xue ban zhu ji
血蝠召唤师	xue fu zhao huan shi
血狂名流	xue kuang ming liu
血瓶贩商	xue ping fan shang
血色塑像	xue se su xiang
血誓扈从	xue shi hu cong
血誓骑士	xue shi qi shi
血税收集官	xue shui shou ji guan
血腥背叛	xue xing bei pan
巡检官雅各布豪肯	xun jian guan ya ge bu hao ken
讯使蝙蝠	xun shi bian fu
芽孢匍菌	ya bao pu jun
研虫专家	yan chong zhuan jia
岩浆猛击灵	yan jiang meng ji ling
炎佑弩矢	yan you nu shi
羊屯说书人	yang tun shuo shu ren
羊屯吞噬兽	yang tun tun shi shou
野调嚎狼	ye diao hao lang
夜幕降临	ye mu jiang lin
溢电拼合怪	yi dian pin he guai
易怒纵火人	yi nu zong huo ren
翼展征兆	yi zhan zheng zhao
引嚎圆月	yin hao yuan yue
隐居标本师	yin ju biao ben shi
隐匿杀手	yin ni sha shou
隐匿新兵	yin ni xin bing
阴郁的索霖	yin yu de suo lin
迎宾吸血鬼	ying bin xi xue gui
英雄殉身	ying xiong xun shen
英勇以对	ying yong yi dui
涌电狂战士	yong dian kuang zhan shi
游荡灵妖	you dang ling yao
游灯精怪	you deng jing guai
幽魂缚身	you hun fu shen
游魂猎手卡娅	you hun lie shou ka ya
游魂幽笼	you hun you long
浴血欢欣客	yu xue huan xin ke
怨仇亡者多萝霞	yuan chou wang zhe duo luo xia
远古木节妖	yuan gu mu jie yao
远见拼接师基拉夫	yuan jian pin jie shi ji la fu
月光伏击兽	yue guang fu ji shou
跃空尸嵌	yue kong shi qian
月相拒斥	yue xiang ju chi
葬火孽物	zang huo nie wu
遭魅新郎艾德嘉	zao mei xin lang ai de jia
遭弃挥扫械	zao qi hui sao xie
榨干	zha gan
战墓食腐熊	zhan mu shi fu xiong
沼泽	zhao ze
遮物帘幕	zhe wu lian mu
针锋相对	zhen feng xiang dui
致命共舞者	zhi ming gong wu zhe
制图师勘绘	zhi tu shi kan hui
终得安息	zhong de an xi
忠信判官	zhong xin pan guan
逐风龙兽	zhu feng long shou
注亡逆徒	zhu wang ni tu
转化式双面牌	zhuan hua shi shuang mian pai
卓兹克步兵	zhuo zi ke bu bing
卓兹克战具	zhuo zi ke zhan ju
自然之拥	zi ran zhi yong
滋扰游魂	zi rao you hun
滋养存形	zi yang cun xing
滋养猎狼	zi yang lie lang