阿迪里江苏里坦	a di li jiang su li tan
安琦轩	an qi xuan
白丽	bai li
鲍珊菊	bao shan ju
卜廷凯	bu ting kai
蔡琪	cai qi
曹利国	cao li guo
曹缘	cao yuan
曾蕊	ceng rui
曾文蕙	ceng wen hui
曾莹莹	ceng ying ying
常昊	chang hao
昌雅妮	chang ya ni
常园	chang yuan
陈海威	chen hai wei
陈佳鹏	chen jia peng
陈锦丰	chen jin feng
陈静乐	chen jing le
陈俊儿	chen jun er
陈可怡	chen ke yi
陈琳琳	chen lin lin
陈露颖	chen lu ying
陈梦	chen meng
陈明伶	chen ming ling
陈清晨	chen qing chen
陈情缘	chen qing yuan
陈笑	chen xiao
陈阳	chen yang
陈怡	chen yi
陈艺文	chen yi wen
陈雨菲	chen yu fei
陈雨乐	chen yu le
陈芋汐	chen yu xi
陈云霞	chen yun xia
程文涛	cheng wen tao
程玉洁	cheng yu jie
崔宸曦	cui chen xi
崔利宏	cui li hong
崔晓桐	cui xiao tong
戴倩倩	dai qian qian
单梦缘	dan meng yuan
但文	dan wen
邓丽娟	deng li juan
邓雅文	deng ya wen
邓泽文	deng ze wen
邓智舰	deng zhi jian
邓志伟	deng zhi wei
刁琳宇	diao lin yu
丁霞	ding xia
丁欣怡	ding xin yi
董文鑫	dong wen xin
董毅	dong yi
董志豪	dong zhi hao
窦欣蓉	dou xin rong
窦泽成	dou ze cheng
杜林澍	du lin shu
杜思雨	du si yu
范云霞	fan yun xia
樊振东	fan zhen dong
方耀庆	fang yao qing
费立纬	fei li wei
冯彬	feng bin
冯彦哲	feng yan zhe
冯雨	feng yu
冯紫琪	feng zi qi
高唯中	gao wei zhong
高意	gao yi
葛楚彤	ge chu tong
葛曼棋	ge man qi
巩立姣	gong li jiao
龚翔宇	gong xiang yu
谷丙凤	gu bing feng
顾敏	gu min
谷瑶瑶	gu yao yao
郭崎琪	guo qi qi
郭清	guo qing
郭帅	guo shuai
郭裕芳	guo yu fang
郭宗英	guo zong ying
哈比拉阿吾萨衣满	ha bi la a wu sa yi man
韩佳予	han jia yu
韩旭	han xu
韩雪振	han xue zhen
郝婷	hao ting
何冰娇	he bing jiao
何江欣	he jiang xin
何杰	he jie
贺相红	he xiang hong
洪可新	hong ke xin
侯志慧	hou zhi hui
胡晓宇	hu xiao yu
胡译乘	hu yi cheng
胡宇	hu yu
华天	hua tian
黄博凯	huang bo kai
黄东萍	huang dong ping
黄敬业	huang jing ye
黄娟	huang juan
黄齐滨	huang qi bin
黄芊芊	huang qian qian
黄思静	huang si jing
黄雅琼	huang ya qiong
黄雨婷	huang yu ting
黄张嘉洋	huang zhang jia yang
黄卓凡	huang zhuo fan
季博文	ji bo wen
季新杰	ji xin jie
贾一凡	jia yi fan
姜冉馨	jiang ran xin
江伊婷	jiang yi ting
蒋雨露	jiang yu lu
姜志超	jiang zhi chao
焦恩祺	jiao en qi
考文超	kao wen chao
孔雅琪	kong ya qi
兰星宇	lan xing yu
李冰洁	li bing jie
李冬崟	li dong yin
李发彬	li fa bin
李红	li hong
李佳蔓	li jia man
李江燕	li jiang yan
李玲	li ling
李梦	li meng
李倩	li qian
李诗沣	li shi feng
李诗婷	li shi ting
李澍寰	li shu huan
李雯雯	li wen wen
李雪	li xue
李炎东	li yan dong
李盈莹	li ying ying
李宇名	li yu ming
李玉婷	li yu ting
李缘	li yuan
李越宏	li yue hong
李月汝	li yue ru
李志伟	li zhi wei
李中原	li zhong yuan
练俊杰	lian jun jie
梁靖崑	liang jing kun
梁伟铿	liang wei keng
梁小丫	liang xiao ya
梁育帅	liang yu shuai
林倩麒	lin qian qi
林文君	lin wen jun
林希妤	lin xi yu
林鑫瑜	lin xin yu
林雨薇	lin yu wei
刘浩	liu hao
刘虹	liu hong
刘焕华	liu huan hua
刘佳丽	liu jia li
刘俊茜	liu jun qian
刘萍	liu ping
刘琦	liu qi
刘清漪	liu qing yi
刘圣书	liu sheng shu
刘添	liu tian
刘潇倩	liu xiao qian
刘晓鑫	liu xiao xin
柳雅欣	liu ya xin
刘洋	liu yang
刘雨辰	liu yu chen
刘宇坤	liu yu kun
刘治宇	liu zhi yu
龙道一	long dao yi
龙金宝	long jin bao
陆锋	lu feng
鲁诗雨	lu shi yu
陆文博	lu wen bo
鹿译文	lu yi wen
罗欢	luo huan
罗诗芳	luo shi fang
罗帅	luo shuai
罗欣棫	luo xin yu
骆知鹭	luo zhi lu
骆宗诗	luo zong shi
吕会会	lv hui hui
吕健林	lv jian lin
吕先景	lv xian jing
吕扬	lv yang
吕怡筱	lv yi xiao
马龙	ma long
马宁	ma ning
马晓丹	ma xiao dan
马振霞	ma zhen xia
马振昭	ma zhen zhao
麦汇聪	mai hui cong
孟令哲	meng ling zhe
米久江	mi jiu jiang
莫家蝶	mo jia die
莫梓维	mo zi wei
牛春格	niu chun ge
牛广盛	niu guang sheng
农三凤	nong san feng
欧烜屹	ou xuan yi
欧钰珊	ou yu shan
欧紫霞	ou zi xia
潘愚非	pan yu fei
潘展乐	pan zhan le
庞倩玉	pang qian yu
彭旭玮	peng xu wei
蒲彦竹	pu yan zhu
亓祥宇	qi xiang yu
齐迎	qi ying
钱海涛	qian hai tao
切阳什姐	qie yang shen jie
覃海洋	qin hai yang
秦伟搏	qin wei bo
邱祺缘	qiu qi yuan
邱秀萍	qiu xiu ping
全红婵	quan hong chan
全鑫	quan xin
阮洪婷	ruan hong ting
沈晨鹏	shen chen peng
沈双美	shen shuang mei
沈轶能	shen yi neng
盛李豪	sheng li hao
侍聪	shi cong
石雨豪	shi yu hao
石宇奇	shi yu qi
石智勇	shi zhi yong
宋佳媛	song jia yuan
宋洁	song jie
宋兆祥	song zhao xiang
苏琪	su qi
苏炜德	su wei de
粟文	su wen
孙华东	sun hua dong
孙佳俊	sun jia jun
孙佳琪	sun jia qi
孙梦然	sun meng ran
孙梦雅	sun meng ya
孙炜	sun wei
孙一文	sun yi wen
孙颖莎	sun ying sha
孙悦	sun yue
孙悦雯	sun yue wen
谭金僮	tan jin tong
谭宁	tan ning
唐婧	tang jing
唐君瑶	tang jun yao
唐拉提汗	tang la ti han
汤慕涵	tang mu han
唐钱婷	tang qian ting
唐欣	tang xin
万济圆	wan ji yuan
万乐天	wan le tian
王昶	wang chang
王长浩	wang chang hao
王朝朝	wang chao chao
王楚钦	wang chu qin
王赐月	wang ci yue
王丛康	wang cong kang
王浩宇	wang hao yu
王欢	wang huan
王嘉男	wang jia nan
王娟	wang juan
王澜静	wang lan jing
王丽丽	wang li li
王柳懿	wang liu yi
王曼昱	wang man yu
王梦洁	wang meng jie
王楠	wang nan
王琦	wang qi
王芊懿	wang qian yi
汪顺	wang shun
王思雨	wang si yu
王婉钰	wang wan yu
王曦雨	wang xi yu
王笑	wang xiao
王鑫杰	wang xin jie
王欣瑜	wang xin yu
王翾	wang xuan
汪雪儿	wang xue er
王岩	wang yan
王艺迪	wang yi di
王雨婷	wang yu ting
王媛媛	wang yuan yuan
王振	wang zhen
王峥	wang zheng
王子凤	wang zi feng
王子杰	wang zi jie
王子露	wang zi lu
王梓赛	wang zi sai
王宗源	wang zong yuan
魏萌	wei meng
温在鼎	wen zai ding
吴斌	wu bin
武翠翠	wu cui cui
吴梦洁	wu meng jie
伍鹏	wu peng
吴卿风	wu qing feng
武桐桐	wu tong tong
吴向东	wu xiang dong
吴艳妮	wu yan ni
吴愉	wu yu
伍志帆	wu zhi fan
吴智强	wu zhi qiang
夏欣怡	xia xin yi
夏雨雨	xia yu yu
向玢璇	xiang fen xuan
肖若腾	xiao ruo teng
肖雁宁	xiao yan ning
谢思埸	xie si yi
谢瑜	xie yu
谢震业	xie zhen ye
谢智宇	xie zhi yu
辛鑫	xin xin
熊敦瀚	xiong dun han
熊诗麒	xiong shi qi
徐嘉余	xu jia yu
许杰	xu jie
许诺	xu nuo
徐诗晓	xu shi xiao
徐仕妍	xu shi yan
许双双	xu shuang shuang
徐纹娱	xu wen yu
徐星叶	xu xing ye
徐臧军	xu zang jun
徐卓一	xu zhuo yi
许紫春	xu zi chun
薛晨	xue chen
严海滨	yan hai bin
阎菁	yan jing
严浪宇	yan lang yu
闫美玲	yan mei ling
严思雅	yan si ya
闫铮	yan zheng
杨畅	yang chang
杨飞飞	yang fei fei
杨昊	yang hao
杨恒郁	yang heng yu
杨家玉	yang jia yu
杨浚瑄	yang jun xuan
杨力维	yang li wei
杨柳	yang liu
杨榴	yang liu
杨绍辉	yang shao hui
杨舒予	yang shu yu
杨思琪	yang si qi
杨文璐	yang wen lu
杨晓蕾	yang xiao lei
杨一凡	yang yi fan
姚捷	yao jie
叶娇	ye jiao
叶诗文	ye shi wen
殷梦蝶	yin meng die
殷若宁	yin ruo ning
尤浩	you hao
余垵慧	yu an hui
于海成	yu hai cheng
俞诗梦	yu shi meng
余思涵	yu si han
余依婷	yu yi ting
苑丽颖	yuan li ying
袁心玥	yuan xin yue
袁也淳	yuan ye chun
袁悦	yuan yue
张博恒	zhang bo heng
张博文	zhang bo wen
张常宁	zhang chang ning
张德顺	zhang de shun
张冬	zhang dong
张海蓉	zhang hai rong
张婧	zhang jing
张俊	zhang jun
张灵	zhang ling
张溟鲲	zhang ming kun
张明煜	zhang ming yu
张宁	zhang ning
张清颖	zhang qing ying
张琼月	zhang qiong yue
张茹	zhang ru
张书贤	zhang shu xian
张帅	zhang shuai
张鑫秋	zhang xin qiu
张雅怡	zhang ya yi
张怡涵	zhang yi han
张影	zhang ying
张雨霏	zhang yu fei
张悦彤	zhang yue tong
张展硕	zhang zhan shuo
张芷婷	zhang zhi ting
张之臻	zhang zhi zhen
赵嘉仁	zhao jia ren
赵杰	zhao jie
赵楠	zhao nan
赵雅婷	zhao ya ting
郑好好	zheng hao hao
郑钦文	zheng qin wen
郑赛赛	zheng sai sai
郑思维	zheng si wei
郑益昕	zheng yi xin
钟嘉琪	zhong jia qi
钟淇云	zhong qi yun
钟涛	zhong tao
周凤	zhou feng
周娅菲	zhou ya fei
周雅琴	zhou ya qin
周燕	zhou yan
周瑜	zhou yu
周泽琪	zhou ze qi
朱婷	zhu ting
朱雪莹	zhu xue ying
朱亚明	zhu ya ming
朱叶青	zhu ye qing
朱渊博	zhu yuan bo
朱沅铃	zhu yuan ling
庄宇珊	zhuang yu shan
邹佳琪	zou jia qi
邹敬园	zou jing yuan
邹妹容	zou mei rong
邹万豪	zou wan hao