爆炸其他	bao zha qi ta
爆炸设计	bao zha she ji
爆炸真实的	bao zha zhen shi de
冰打击	bing da ji
冰打碎	bing da sui
冰挤压	bing ji ya
冰其他	bing qi ta
冰碎片	bing sui pian
冰移动	bing yi dong
冰音乐性	bing yin yue xing
冰抓取	bing zhua qu
玻璃打击	bo li da ji
玻璃打碎	bo li da sui
玻璃挤压	bo li ji ya
玻璃其他	bo li qi ta
玻璃碎片	bo li sui pian
玻璃移动	bo li yi dong
玻璃音乐性	bo li yin yue xing
玻璃抓取	bo li zhua qu
布料打击	bu liao da ji
布料抖动	bu liao dou dong
布料其他	bu liao qi ta
布料撕扯	bu liao si che
布料移动	bu liao yi dong
布料抓取	bu liao zhua qu
拆除倒塌	chai chu dao ta
拆除其他	chai chu qi ta
拆除碎片	chai chu sui pian
车辆窗	che liang chuang
车辆打滑	che liang da hua
车辆电动	che liang dian dong
车辆工程车	che liang gong cheng che
车辆公交车	che liang gong jiao che
车辆工具车	che liang gong ju che
车辆古董车	che liang gu dong che
车辆货车	che liang huo che
车辆机械	che liang ji xie
车辆紧急状态	che liang jin ji zhuang tai
车辆警报	che liang jing bao
车辆警报车辆	che liang jing bao che liang
车辆军用	che liang jun yong
车辆轮胎打滑	che liang lun tai da hua
车辆马车	che liang ma che
车辆门	che liang men
车辆鸣笛	che liang ming di
车辆摩托车	che liang mo tuo che
车辆内部	che liang nei bu
车辆农场	che liang nong chang
车辆汽车	che liang qi che
车辆其他	che liang qi ta
车辆全地形车	che liang quan di xing che
车辆赛车	che liang sai che
车辆刹车	che liang sha che
车辆通用经过	che liang tong yong jing guo
车辆熄火	che liang xi huo
车辆厢式车	che liang xiang shi che
车辆悬挂	che liang xuan gua
车辆自行车	che liang zi xing che
翅膀昆虫	chi bang kun chong
翅膀鸟	chi bang niao
翅膀其他	chi bang qi ta
翅膀生物	chi bang sheng wu
抽屉金属	chou ti jin shu
抽屉木头	chou ti mu tou
抽屉其他	chou ti qi ta
抽屉塑料	chou ti su liao
船舶捕鱼	chuan bo bu yu
船舶船笛	chuan bo chuan di
船舶船浪	chuan bo chuan lang
船舶大船	chuan bo da chuan
船舶电动船	chuan bo dian dong chuan
船舶帆船	chuan bo fan chuan
船舶划艇	chuan bo hua ting
船舶机械	chuan bo ji xie
船舶军用	chuan bo jun yong
船舶门	chuan bo men
船舶摩托艇	chuan bo mo tuo ting
船舶内部	chuan bo nei bu
船舶其他	chuan bo qi ta
船舶汽艇	chuan bo qi ting
船舶潜艇	chuan bo qian ting
船舶赛艇	chuan bo sai ting
船舶水下	chuan bo shui xia
船舶蒸汽船	chuan bo zheng qi chuan
窗户窗具	chuang hu chuang ju
窗户金属	chuang hu jin shu
窗户木头	chuang hu mu tou
窗户其他	chuang hu qi ta
窗户敲窗	chuang hu qiao chuang
窗户塑料	chuang hu su liao
窗户遮挡物	chuang hu zhe dang wu
打斗打击	da dou da ji
打斗跌倒	da dou die dao
打斗其他	da dou qi ta
打斗衣服	da dou yi fu
打斗抓握	da dou zhua wo
大物件呼呼	da wu jian hu hu
地热间歇泉	di re jian xie quan
地热泥浆	di re ni jiang
地热其他	di re qi ta
地热热浆	di re re jiang
地热岩浆	di re yan jiang
电流电磁	dian liu dian ci
电流电弧	dian liu dian hu
电流电火花	dian liu dian huo hua
电流电流声	dian liu dian liu sheng
电流漏电	dian liu lou dian
电流其他	dian liu qi ta
电脑键鼠	dian nao jian shu
电脑其他	dian nao qi ta
电脑硬盘	dian nao ying pan
动物蝙蝠	dong wu bian fu
动物狗	dong wu gou
动物家猫	dong wu jia mao
动物昆虫	dong wu kun chong
动物两栖	dong wu liang qi
动物灵长类	dong wu ling zhang lei
动物马	dong wu ma
动物猫科	dong wu mao ke
动物啮齿类	dong wu nie chi lei
动物爬行	dong wu pa xing
动物其他	dong wu qi ta
动物犬科	dong wu quan ke
动物水生	dong wu shui sheng
动物养殖场	dong wu yang zhi chang
动物野生	dong wu ye sheng
发动机电动	fa dong ji dian dong
发动机老式	fa dong ji lao shi
发动机内燃机	fa dong ji nei ran ji
发动机其他	fa dong ji qi ta
发动机伺服电机	fa dong ji si fu dian ji
发动机涡轮	fa dong ji wo lun
放屁其他	fang pi qi ta
放屁设计	fang pi she ji
放屁真实的	fang pi zhen shi de
风大风	feng da feng
风内部	feng nei bu
风设计	feng she ji
风通用	feng tong yong
风音乐性	feng yin yue xing
风阵风	feng zhen feng
风植物	feng zhi wu
工具电动	gong ju dian dong
工具花园	gong ju hua yuan
工具气动	gong ju qi dong
工具其他	gong ju qi ta
工具手持	gong ju shou chi
归档参考素材	gui dang can kao su cai
归档测试音	gui dang ce shi yin
归档场景素材	gui dang chang jing su cai
归档导出	gui dang dao chu
归档过程中素材	gui dang guo cheng zhong su cai
归档混音	gui dang hun yin
归档卷积混响素材	gui dang juan ji hun xiang su cai
归档其他产品素材	gui dang qi ta chan pin su cai
归档商标音	gui dang shang biao yin
归档未确认素材	gui dang wei que ren su cai
归档现场录音	gui dang xian chang lu yin
归档循环群组	gui dang xun huan qun zu
归档原始素材	gui dang yuan shi su cai
归档资源	gui dang zi yuan
航空器火箭	hang kong qi huo jian
航空器机械	hang kong qi ji xie
航空器军用	hang kong qi jun yong
航空器螺旋桨	hang kong qi luo xuan jiang
航空器门	hang kong qi men
航空器内部	hang kong qi nei bu
航空器喷气式	hang kong qi pen qi shi
航空器其他	hang kong qi qi ta
航空器无线电遥控	hang kong qi wu xian dian yao kong
航空器直升机	hang kong qi zhi sheng ji
号角传统	hao jiao chuan tong
号角欢庆用	hao jiao huan qing yong
号角其他	hao jiao qi ta
号角气压式	hao jiao qi ya shi
化学反应	hua xue fan ying
化学腐蚀	hua xue fu shi
化学其他	hua xue qi ta
环境办公室	huan jing ban gong shi
环境餐馆	huan jing can guan
环境草地	huan jing cao di
环境城市	huan jing cheng shi
环境地下	huan jing di xia
环境冻土	huan jing dong tu
环境房间底噪	huan jing fang jian di zao
环境高科技	huan jing gao ke ji
环境高山	huan jing gao shan
环境公共场所	huan jing gong gong chang suo
环境工业	huan jing gong ye
环境公园	huan jing gong yuan
环境海边	huan jing hai bian
环境航海	huan jing hang hai
环境湖岸	huan jing hu an
环境监狱	huan jing jian yu
环境郊区	huan jing jiao qu
环境交通	huan jing jiao tong
环境交通工具	huan jing jiao tong gong ju
环境紧急	huan jing jin ji
环境科幻	huan jing ke huan
环境空气	huan jing kong qi
环境昆虫	huan jing kun chong
环境历史年代	huan jing li shi nian dai
环境鸟叫	huan jing niao jiao
环境农场	huan jing nong chang
环境农村	huan jing nong cun
环境奇幻	huan jing qi huan
环境其他	huan jing qi ta
环境庆典	huan jing qing dian
环境热带	huan jing re dai
环境森林	huan jing sen lin
环境沙漠	huan jing sha mo
环境设计	huan jing she ji
环境市场	huan jing shi chang
环境施工	huan jing shi gong
环境水下	huan jing shui xia
环境小镇	huan jing xiao zhen
环境学校	huan jing xue xiao
环境医院	huan jing yi yuan
环境游行	huan jing you xing
环境娱乐	huan jing yu le
环境运动场	huan jing yun dong chang
环境战争	huan jing zhan zheng
环境沼泽地	huan jing zhao ze di
环境住宅区	huan jing zhu zhai qu
环境宗教场所	huan jing zong jiao chang suo
火爆裂	huo bao lie
火爆燃	huo bao ran
火车地铁	huo che di tie
火车电车	huo che dian che
火车电力机车	huo che dian li ji che
火车高速列车	huo che gao su lie che
火车机械	huo che ji xie
火车哐当	huo che kuang dang
火车门	huo che men
火车鸣笛	huo che ming di
火车内部	huo che nei bu
火车内燃机车	huo che nei ran ji che
火车其他	huo che qi ta
火车刹车	huo che sha che
火车蒸汽火车	huo che zheng qi huo che
火点火	huo dian huo
火呼呼声	huo hu hu sheng
火火炬	huo huo ju
火其他	huo qi ta
火气体	huo qi ti
火燃烧	huo ran shao
火汹涌火势	huo xiong yong huo shi
火滋滋声	huo zi zi sheng
激光打击	ji guang da ji
激光光束	ji guang guang shu
激光其他	ji guang qi ta
激光枪炮	ji guang qiang pao
机器办公设备	ji qi ban gong she bei
机器泵	ji qi beng
机器电梯	ji qi dian ti
机器风扇	ji qi feng shan
机器工业	ji qi gong ye
机器花园	ji qi hua yuan
机器机械	ji qi ji xie
机器家电	ji qi jia dian
机器健身房	ji qi jian shen fang
机器空调	ji qi kong tiao
机器老式的	ji qi lao shi de
机器其他	ji qi qi ta
机器人其他	ji qi ren qi ta
机器人移动	ji qi ren yi dong
机器人语音	ji qi ren yu yin
机器施工	ji qi shi gong
机器数码	ji qi shu ma
机器医疗	ji qi yi liao
机器娱乐	ji qi yu le
机器自动扶梯	ji qi zi dong fu ti
机械操纵杆	ji xie cao zong gan
机械插销	ji xie cha xiao
机械齿轮	ji xie chi lun
机械传动	ji xie chuan dong
机械滚筒	ji xie gun tong
机械滑轮	ji xie hua lun
机械棘轮	ji xie ji lun
机械咔哒	ji xie ka da
机械开关	ji xie kai guan
机械其他	ji xie qi ta
机械锁	ji xie suo
机械液压与气动	ji xie ye ya yu qi dong
脚步动物	jiao bu dong wu
脚步怪物	jiao bu guai wu
脚步马	jiao bu ma
脚步其他	jiao bu qi ta
脚步人类	jiao bu ren lei
金属打击	jin shu da ji
金属打碎	jin shu da sui
金属挤压	jin shu ji ya
金属其他	jin shu qi ta
金属碎片	jin shu sui pian
金属移动	jin shu yi dong
金属音乐性	jin shu yin yue xing
金属抓取	jin shu zhua qu
警报电器	jing bao dian qi
警报蜂鸣器	jing bao feng ming qi
警报警报	jing bao jing bao
警报警铃	jing bao jing ling
警报其他	jing bao qi ta
警报钟表	jing bao zhong biao
卡通颤音	ka tong chan yin
卡通打击	ka tong da ji
卡通道具	ka tong dao ju
卡通动物	ka tong dong wu
卡通嘎吱	ka tong ga zhi
卡通咣当	ka tong guang dang
卡通号	ka tong hao
卡通机器	ka tong ji qi
卡通拉链	ka tong la lian
卡通摩擦	ka tong mo ca
卡通啪嗒	ka tong pa da
卡通其他	ka tong qi ta
卡通哨子	ka tong shao zi
卡通伸缩	ka tong shen suo
卡通嗖嗖	ka tong sou sou
卡通弹拨	ka tong tan bo
卡通弹拨声	ka tong tan bo sheng
卡通弹簧音	ka tong tan huang yin
卡通摇晃	ka tong yao huang
卡通语音	ka tong yu yin
卡通乐句	ka tong yue ju
卡通载具	ka tong zai ju
科幻打击	ke huan da ji
科幻电脑	ke huan dian nao
科幻复古	ke huan fu gu
科幻机器	ke huan ji qi
科幻机械	ke huan ji xie
科幻警报	ke huan jing bao
科幻门	ke huan men
科幻能量	ke huan neng liang
科幻其他	ke huan qi ta
科幻太空船	ke huan tai kong chuan
科幻武器	ke huan wu qi
科幻载具	ke huan zai ju
链条打击	lian tiao da ji
链条打碎	lian tiao da sui
链条其他	lian tiao qi ta
链条移动	lian tiao yi dong
链条抓取	lian tiao zhua qu
门玻璃	men bo li
门传统大门	men chuan tong da men
门电动	men dian dong
门嘎吱	men ga zhi
门高科技	men gao ke ji
门古董	men gu dong
门滑门	men hua men
门家电	men jia dian
门金属	men jin shu
门牢门	men lao men
门木门	men mu men
门其他	men qi ta
门敲门	men qiao men
门石门	men shi men
门双开	men shuang kai
门塑料	men su liao
门锁具	men suo ju
门特殊材料	men te shu cai liao
门箱柜	men xiang gui
门旋转	men xuan zhuan
门液压与气动	men ye ya yu qi dong
门闸门	men zha men
魔法噗	mo fa pu
魔法其他	mo fa qi ta
魔法闪耀	mo fa shan yao
魔法神圣	mo fa shen sheng
魔法邪恶	mo fa xie e
魔法元素	mo fa yuan su
魔法咒语	mo fa zhou yu
木头打击	mu tou da ji
木头打碎	mu tou da sui
木头挤压	mu tou ji ya
木头其他	mu tou qi ta
木头碎片	mu tou sui pian
木头移动	mu tou yi dong
木头音乐性	mu tou yin yue xing
木头抓取	mu tou zhua qu
拟音布料	ni yin bu liao
拟音道具	ni yin dao ju
拟音脚步	ni yin jiao bu
拟音其他	ni yin qi ta
拟音手	ni yin shou
鸟类海鸟	niao lei hai niao
鸟类家禽	niao lei jia qin
鸟类猛禽	niao lei meng qin
鸟类鸣鸟	niao lei ming niao
鸟类其他	niao lei qi ta
鸟类热带	niao lei re dai
鸟类涉禽	niao lei she qin
鸟类乌鸦	niao lei wu ya
皮革打击	pi ge da ji
皮革嘎吱	pi ge ga zhi
皮革其他	pi ge qi ta
皮革移动	pi ge yi dong
皮革抓取	pi ge zhua qu
气体爆发	qi ti bao fa
气体抽吸	qi ti chou xi
气体吹	qi ti chui
气体其他	qi ti qi ta
气体嘶嘶声	qi ti si si sheng
枪炮步枪	qiang pao bu qiang
枪炮操作	qiang pao cao zuo
枪炮高科技	qiang pao gao ke ji
枪炮古董枪	qiang pao gu dong qiang
枪炮火炮	qiang pao huo pao
枪炮机械	qiang pao ji xie
枪炮加农炮	qiang pao jia nong pao
枪炮其他	qiang pao qi ta
枪炮手枪	qiang pao shou qiang
枪炮霰弹枪	qiang pao xian dan qiang
枪炮消音枪	qiang pao xiao yin qiang
枪炮自动化武器	qiang pao zi dong hua wu qi
人吹	ren chui
人打嗝	ren da ge
人打鼾	ren da han
人呼吸	ren hu xi
人咳嗽	ren ke sou
人尿	ren niao
人呕吐	ren ou tu
人喷嚏	ren pen ti
人皮肤	ren pi fu
人其他	ren qi ta
人亲吻	ren qin wen
人群安静	ren qun an jing
人群打斗	ren qun da dou
人群儿童	ren qun er tong
人群反应	ren qun fan ying
人群愤怒	ren qun fen nu
人群歌唱	ren qun ge chang
人群喝彩	ren qun he cai
人群欢呼	ren qun huan hu
人群恐慌	ren qun kong huang
人群其他	ren qun qi ta
人群庆祝	ren qun qing zhu
人群群杂	ren qun qun za
人群谈话	ren qun tan hua
人群笑	ren qun xiao
人群循环群杂	ren qun xun huan qun za
人群运动	ren qun yun dong
人吐	ren tu
人闻	ren wen
人心跳	ren xin tiao
沙土打击	sha tu da ji
沙土灰尘	sha tu hui chen
沙土其他	sha tu qi ta
沙土碎片	sha tu sui pian
沙土移动	sha tu yi dong
沙土音乐性	sha tu yin yue xing
沙土抓取	sha tu zhua qu
哨声机械的	shao sheng ji xie de
哨声其他	shao sheng qi ta
哨声人	shao sheng ren
生物怪兽	sheng wu guai shou
生物鬼魂	sheng wu gui hun
生物精灵生物	sheng wu jing ling sheng wu
生物巨型昆虫	sheng wu ju xing kun chong
生物巨型爬行生物	sheng wu ju xing pa xing sheng wu
生物恐龙	sheng wu kong long
生物类人生物	sheng wu lei ren sheng wu
生物龙	sheng wu long
生物黏体生物	sheng wu nian ti sheng wu
生物奇幻禽类	sheng wu qi huan qin lei
生物其他	sheng wu qi ta
生物人声包	sheng wu ren sheng bao
生物水生	sheng wu shui sheng
生物小型神话生物	sheng wu xiao xing shen hua sheng wu
生物野兽	sheng wu ye shou
声音设计次声波	sheng yin she ji ci sheng bo
声音设计打击	sheng yin she ji da ji
声音设计低频号角	sheng yin she ji di pin hao jiao
声音设计低频轰鸣	sheng yin she ji di pin hong ming
声音设计低频下潜	sheng yin she ji di pin xia qian
声音设计低音氛围	sheng yin she ji di yin fen wei
声音设计电子合成	sheng yin she ji dian zi he cheng
声音设计鬼魅飘渺	sheng yin she ji gui mei piao miao
声音设计合成器	sheng yin she ji he cheng qi
声音设计呼啸	sheng yin she ji hu xiao
声音设计尖锐弦乐	sheng yin she ji jian rui xian yue
声音设计节奏性	sheng yin she ji jie zou xing
声音设计粒状	sheng yin she ji li zhuang
声音设计毛骨悚然	sheng yin she ji mao gu song ran
声音设计其他	sheng yin she ji qi ta
声音设计人声	sheng yin she ji ren sheng
声音设计上升	sheng yin she ji shang sheng
声音设计失真	sheng yin she ji shi zhen
声音设计音乐性	sheng yin she ji yin yue xing
声音设计原始录音	sheng yin she ji yuan shi lu yin
绳子打击	sheng zi da ji
绳子其他	sheng zi qi ta
绳子移动	sheng zi yi dong
绳子抓取	sheng zi zhua qu
绳子作响	sheng zi zuo xiang
石头打击	shi tou da ji
石头打碎	shi tou da sui
石头挤压	shi tou ji ya
石头其他	shi tou qi ta
石头碎片	shi tou sui pian
石头移动	shi tou yi dong
石头音乐性	shi tou yin yue xing
石头抓取	shi tou zhua qu
水波浪	shui bo lang
水打击	shui da ji
水倒水	shui dao shui
水滴	shui di
水管道	shui guan dao
水浪花拍岸	shui lang hua pai an
水拍浪	shui pai lang
水排水	shui pai shui
水喷泉	shui pen quan
水泼洒飞溅	shui po sa fei jian
水瀑布	shui pu bu
水气泡	shui qi pao
水气泡破裂	shui qi pao po lie
水其他	shui qi ta
水水花喷雾	shui shui hua pen wu
水水流	shui shui liu
水水下	shui shui xia
水汹涌澎湃	shui xiong yong peng pai
水移动	shui yi dong
水蒸汽	shui zheng qi
塑料打击	su liao da ji
塑料打碎	su liao da sui
塑料挤压	su liao ji ya
塑料其他	su liao qi ta
塑料碎片	su liao sui pian
塑料移动	su liao yi dong
塑料音乐性	su liao yin yue xing
塑料抓取	su liao zhua qu
陶瓷打击	tao ci da ji
陶瓷打碎	tao ci da sui
陶瓷挤压	tao ci ji ya
陶瓷其他	tao ci qi ta
陶瓷碎片	tao ci sui pian
陶瓷移动	tao ci yi dong
陶瓷音乐性	tao ci yin yue xing
陶瓷抓取	tao ci zhua qu
提示音车辆	ti shi yin che liang
提示音低保真	ti shi yin di bao zhen
提示音电器	ti shi yin dian qi
提示音计时器	ti shi yin ji shi qi
提示音通用	ti shi yin tong yong
提示音医疗器械	ti shi yin yi liao qi xie
天气冰雹	tian qi bing bao
天气风暴	tian qi feng bao
天气雷	tian qi lei
天气其他	tian qi qi ta
通讯打字机	tong xun da zi ji
通讯电话	tong xun dian hua
通讯电视机	tong xun dian shi ji
通讯干扰	tong xun gan rao
通讯留声机	tong xun liu sheng ji
通讯麦克风	tong xun mai ke feng
通讯其他	tong xun qi ta
通讯手机	tong xun shou ji
通讯收音机	tong xun shou yin ji
通讯无线电	tong xun wu xian dian
通讯相机	tong xun xiang ji
通讯信号收发机	tong xun xin hao shou fa ji
通讯影视设备	tong xun ying shi she bei
玩具电动	wan ju dian dong
玩具机械	wan ju ji xie
玩具其他	wan ju qi ta
物件办公用品	wu jian ban gong yong pin
物件包袋	wu jian bao dai
物件包装品	wu jian bao zhuang pin
物件花园	wu jian hua yuan
物件家具	wu jian jia ju
物件家用品	wu jian jia yong pin
物件健身房	wu jian jian shen fang
物件胶带制品	wu jian jiao dai zhi pin
物件拉链	wu jian la lian
物件其他	wu jian qi ta
物件容器	wu jian rong qi
物件伞	wu jian san
物件时尚	wu jian shi shang
物件书籍	wu jian shu ji
物件书写用品	wu jian shu xie yong pin
物件行李	wu jian xing li
物件钥匙	wu jian yao shi
物件医疗	wu jian yi liao
物件硬币	wu jian ying bi
物件有轮制品	wu jian you lun zhi pin
物件珠宝首饰	wu jian zhu bao shou shi
武器鞭子	wu qi bian zi
武器刀	wu qi dao
武器钝器	wu qi dun qi
武器斧头	wu qi fu tou
武器弓	wu qi gong
武器护甲	wu qi hu jia
武器剑	wu qi jian
武器箭	wu qi jian
武器矛	wu qi mao
武器其他	wu qi qi ta
武器投石机	wu qi tou shi ji
橡胶打击	xiang jiao da ji
橡胶挤压	xiang jiao ji ya
橡胶其他	xiang jiao qi ta
橡胶碎片	xiang jiao sui pian
橡胶移动	xiang jiao yi dong
橡胶音乐性	xiang jiao yin yue xing
橡胶抓取	xiang jiao zhua qu
小物件嗖嗖	xiao wu jian sou sou
雪打击	xue da ji
血骨头	xue gu tou
雪挤压	xue ji ya
血其他	xue qi ta
雪其他	xue qi ta
血燃烧	xue ran shao
血洒溅	xue sa jian
血渗血	xue shen xue
雪碎片	xue sui pian
血捅	xue tong
血血浆	xue xue jiang
血血流	xue xue liu
血血肉	xue xue rou
雪移动	xue yi dong
血原始录音	xue yuan shi lu yin
雪抓取	xue zhua qu
烟花其他	yan hua qi ta
烟花商业表演	yan hua shang ye biao yan
烟花自娱	yan hua zi yu
液体打击	ye ti da ji
液体咕嘟	ye ti gu du
液体气泡	ye ti qi pao
液体其他	ye ti qi ta
液体移动	ye ti yi dong
移动单人	yi dong dan ren
移动动物	yi dong dong wu
移动昆虫	yi dong kun chong
移动其他	yi dong qi ta
移动人类活动	yi dong ren lei huo dong
移动人群	yi dong ren qun
移动社会活动	yi dong she hui huo dong
移动生物	yi dong sheng wu
饮食玻璃器皿	yin shi bo li qi min
饮食餐具	yin shi can ju
饮食吃	yin shi chi
饮食厨具	yin shi chu ju
饮食喝	yin shi he
饮食烹饪	yin shi peng ren
饮食泼洒	yin shi po sa
饮食其他	yin shi qi ta
饮食食材	yin shi shi cai
音乐表演	yin yue biao yan
音乐拨弦乐	yin yue bo xian le
音乐采样	yin yue cai yang
音乐打击琴	yin yue da ji qin
音乐打击乐	yin yue da ji yue
音乐段子	yin yue duan zi
音乐合唱	yin yue he chang
音乐合成器	yin yue he cheng qi
音乐键控	yin yue jian kong
音乐木管	yin yue mu guan
音乐其他	yin yue qi ta
音乐沙棒	yin yue sha bang
音乐实验	yin yue shi yan
音乐铜管	yin yue tong guan
音乐玩具	yin yue wan ju
音乐弦乐	yin yue xian yue
音乐循环	yin yue xun huan
音乐乐器	yin yue yue qi
音乐重击音	yin yue zhong ji yin
音乐钟铃	yin yue zhong ling
音乐钟声	yin yue zhong sheng
用户界面嘀嘟哔	yong hu jie mian di du bi
用户界面点击	yong hu jie mian dian ji
用户界面动态	yong hu jie mian dong tai
用户界面故障	yong hu jie mian gu zhang
用户界面其他	yong hu jie mian qi ta
用户界面数据	yong hu jie mian shu ju
用户界面提示	yong hu jie mian ti shi
游戏单机	you xi dan ji
游戏赌场	you xi du chang
游戏街机	you xi jie ji
游戏其他	you xi qi ta
游戏桌游	you xi zhuo you
雨玻璃	yu bo li
雨布料	yu bu liao
雨金属	yu jin shu
雨木头	yu mu tou
雨内部	yu nei bu
雨水	yu shui
雨水泥	yu shui ni
雨塑料	yu su liao
雨通用	yu tong yong
语音儿童	yu yin er tong
语音反应	yu yin fan ying
语音歌唱	yu yin ge chang
语音呼喝	yu yin hu he
语音欢呼	yu yin huan hu
语音尖叫	yu yin jian jiao
语音哭	yu yin ku
语音历史年代	yu yin li shi nian dai
语音男性	yu yin nan xing
语音女性	yu yin nv xing
语音其他	yu yin qi ta
语音窃语	yu yin qie yu
语音外星人	yu yin wai xing ren
语音笑	yu yin xiao
语音音响化	yu yin yin xiang hua
语音婴儿	yu yin ying er
雨植物	yu zhi wu
运动冰上	yun dong bing shang
运动冬季	yun dong dong ji
运动户外	yun dong hu wai
运动健身	yun dong jian shen
运动其他	yun dong qi ta
运动球类	yun dong qiu lei
运动室内	yun dong shi nei
运动水上	yun dong shui shang
运动田径	yun dong tian jing
灾害地震	zai hai di zhen
灾害火山喷发	zai hai huo shan pen fa
灾害龙卷风	zai hai long juan feng
灾害其他	zai hai qi ta
灾害热带风暴	zai hai re dai feng bao
灾害台风	zai hai tai feng
灾害雪崩	zai hai xue beng
纸打击	zhi da ji
纸抖动	zhi dou dong
纸挤压	zhi ji ya
纸其他	zhi qi ta
纸撕扯	zhi si che
植物草	zhi wu cao
植物其他	zhi wu qi ta
植物树	zhi wu shu
植物叶	zhi wu ye
纸音乐性	zhi yin yue xing
纸抓取	zhi zhua qu
钟表报时	zhong biao bao shi
钟表嘀嗒	zhong biao di da
钟表机械	zhong biao ji xie
钟表其他	zhong biao qi ta
钟铃大钟	zhong ling da zhong
钟铃动物	zhong ling dong wu
钟铃锣	zhong ling luo
钟铃门铃	zhong ling men ling
钟铃其他	zhong ling qi ta
钟铃手铃	zhong ling shou ling
装备高科技	zhuang bei gao ke ji
装备户外	zhuang bei hu wai
装备其他	zhuang bei qi ta
装备挽具	zhuang bei wan ju
装备运动	zhuang bei yun dong
装备战术	zhuang bei zhan shu
子弹弹壳	zi dan dan ke
子弹飞过	zi dan fei guo
子弹击中	zi dan ji zhong
子弹其他	zi dan qi ta
子弹弹跳	zi dan tan tiao