爱音	ai yin
八潮瑠唯	ba chao liu wei
八幡海铃	ba fan hai ling
白金燐子	bai jin lin zi
白鹭千圣	bai lu qian sheng
邦邦	bang bang
邦高祖	bang gao zu
北泽育美	bei ze yu mei
冰川纱夜	bing chuan sha ye
仓田真白	cang tian zhen bai
长崎素世	chang qi su shi
纯田真奈	chun tian zhen nai
从来没有觉得开心过	cong lai mei you jue de kai xin guo
凑友希那	cou you xi na
都筑诗船	dou zhu shi chuan
二叶筑紫	er ye zhu zi
飞鸟山	fei niao shan
飞鸟山公园	fei niao shan gong yuan
丰川祥子	feng chuan xiang zi
高松灯	gao song deng
广町七深	guang ding qi shen
海铃	hai ling
和奏瑞依	he zou rui yi
户山香澄	hu shan xiang cheng
花咲川	hua xiao chuan
花园妙	hua yuan miao
黄瓜睦	huang gua mu
今井莉莎	jin jing li sha
鸠谷米歇尔	jiu gu mi xie er
濑田薰	lai tian xun
蓝色章鱼	lan se zhang yu
乐奈	le nai
立希	li xi
灵感菇	ling gan gu
美竹兰	mei zhu lan
米歇尔	mi xie er
喵梦	miao meng
喵梦亲	miao meng qin
牛込里美	niu yu li mei
偶捏该	ou nie gai
千早爱音	qian zao ai yin
青叶摩卡	qing ye mo ka
若麦	ruo mai
若叶睦	ruo ye mu
三角初华	san jiao chu hua
三角初音	san jiao chu yin
山吹沙绫	shan chui sha ling
上原绯玛丽	shang yuan fei ma li
市谷有咲	shi gu you xiao
松原花音	song yuan hua yin
甜甜圈女士	tian tian quan nv shi
桐谷透子	tong gu tou zi
偷摸零	tou mo ling
哇达西	wa da xi
丸山彩	wan shan cai
弦卷心	xian juan xin
要乐奈	yao le nai
祐天寺	you tian si
祐天寺若麦	you tian si ruo mai
羽丘	yu qiu
羽丘麻美	yu qiu ma mei
宇田川亚子	yu tian chuan ya zi
月之森	yue zhi sen
朝日六花	zhao ri liu hua
椎名	zhui ming
椎名立希	zhui ming li xi
佐仓杏子	zuo cang xing zi
佐藤益木	zuo teng yi mu