阿威十八式	a wei shi ba shi
爱之马杀鸡	ai zhi ma sha ji
暗流涌动	an liu yong dong
八奇技	ba qi ji
白式雪	bai shi xue
碧游村	bi you cun
碧游村新截教	bi you cun xin jie jiao
毕游龙	bi you long
不摇碧莲	bu yao bi lian
藏龙	cang long
陈朵	chen duo
陈金魁	chen jin kui
邓有福	deng you fu
窦乐	dou le
窦梅	dou mei
冯宝宝	feng bao bao
风莎燕	feng sha yan
风星潼	feng xing tong
风星潼之父	feng xing tong zhi fu
蜂拥而至的异人	feng yong er zhi de yi ren
风正豪	feng zheng hao
傅蓉	fu rong
冈本零点零一	gang ben ling dian ling yi
高二壮	gao er zhuang
高廉	gao lian
高宁	gao ning
各显神通	ge xian shen tong
龚庆	gong qing
狗娃子	gou wa zi
蛊身圣童	gu shen sheng tong
憨蛋儿	han dan er
郝意	hao yi
黑管儿	hei guan er
胡杰	hu jie
胡林	hu lin
华风	hua feng
黄伯仁	huang bo ren
甲申之乱	jia shen zhi luan
贾正亮	jia zheng liang
贾正瑜	jia zheng yu
剑仙传人	jian xian chuan ren
绛宫雷	jiang gong lei
江西龙虎山正一派天师府	jiang xi long hu shan zheng yi pai tian shi fu
金光咒	jin guang zhou
老孟	lao meng
老农功	lao nong gong
雷法	lei fa
雷法阳五雷	lei fa yang wu lei
凉山大觋	liang shan da xi
廖忠	liao zhong
柳妍妍	liu yan yan
陆瑾	lu jin
陆玲珑	lu ling long
罗天大醮	luo tian da jiao
吕慈	lv ci
吕良	lv liang
马仙洪	ma xian hong
茅山上清派	mao shan shang qing pai
米二	mi er
米二老师	mi er lao shi
哪都通快递有限公司	na dou tong kuai di you xian gong si
那一年	na yi nian
炁体源流	qi ti yuan liu
千面人域化毒	qian mian ren yu hua du
全性	quan xing
全真	quan zhen
任菲	ren fei
人口红线	ren kou hong xian
三十六贼	san shi liu zei
沈冲	shen chong
神秘姐姐的造访	shen mi jie jie de zao fang
十二上根器	shi er shang gen qi
十佬之一	shi lao zhi yi
史密斯	shi mi si
田晋中	tian jin zhong
天师	tian shi
天师府	tian shi fu
天下会	tian xia hui
通天箓	tong tian lu
王霭	wang ai
王并	wang bing
王二狗	wang er gou
王也	wang ye
王震球	wang zhen qiu
武当	wu dang
无根生	wu gen sheng
无形大贱	wu xing da jian
巫优神格面具	wu you shen ge mian ju
夏禾	xia he
先天一炁	xian tian yi qi
萧霄	xiao xiao
小羽子	xiao yu zi
肖自在	xiao zi zai
徐三	xu san
徐四	xu si
徐翔	xu xiang
寻找真相	xun zhao zhen xiang
阳五雷	yang wu lei
药仙会	yao xian hui
曜星社	yao xing she
异人	yi ren
永觉和尚	yong jue he shang
苑陶	yuan tao
张楚岚	zhang chu lan
张怀义	zhang huai yi
张灵玉	zhang ling yu
张锡林	zhang xi lin
张之维	zhang zhi wei
赵方旭	zhao fang xu
枳瑾花	zhi jin hua
诸葛青	zhu ge qing