阿良良木历	a liang liang mu li
艾比所特	ai bi suo te
把贺滤过	ba he lv guo
班长妹	ban zhang mei
班长中的班长	ban zhang zhong de ban zhang
被猫魅惑的少女	bei mao mei huo de shao nv
贝木泥舟	bei mu ni zhou
冰熊戚朗	bing xiong qi lang
长靴顶下	chang xue ding xia
巢内告词	chao nei gao ci
初代怪异杀手	chu dai guai yi sha shou
窗村壁	chuang cun bi
冬波境笃	dong bo jing du
毒舌时代	du she shi dai
恶魔之手	e mo zhi shou
浮飞急须	fu fei ji xu
斧乃木余接	fu nai mu yu jie
服石点呼	fu shi dian hu
割取质枝	ge qu zhi zhi
怪异杀手	guai yi sha shou
怪异之王	guai yi zhi wang
怪异中的怪异	guai yi zhong de guai yi
姬丝秀忒	ji si xiu tei
甲堂草书	jia tang cao shu
精神尚未成熟的家伙	jing shen shang wei cheng shu de jia huo
苦部合图	ku bu he tu
老仓	lao cang
老仓育	lao cang yu
菱形情路	ling xing qing lu
美男子	mei nan zi
目边实粟	mu bian shi su
欧拉	ou la
品庭绫传	pin ting ling chuan
球角瓢衣	qiu jiao piao yi
趣泽住度	qu ze zhu du
忍野咩咩	ren ye mie mie
忍野忍	ren ye ren
忍野扇	ren ye shan
砂浜类瀬	sha bang lei lai
神原骏河	shen yuan jun he
深远霜乃	shen yuan shuang nai
实崎明媚	shi qi ming mei
手折正弦	shou zhe zheng xian
速町整子	su ding zheng zi
汤场职则	tang chang zhi ze
糖根轴	tang gen zhou
题野木莓	ti ye mu mei
铁条径	tie tiao jing
铁血的热血的冷血的吸血鬼	tie xue de re xue de leng xue de xi xue gui
图书委员	tu shu wei yuan
问嶋水仙	wen dao shui xian
卧烟伊豆湖	wo yan yi dou hu
西尾维新	xi wei wei xin
小马冲忠	xiao ma chong zhong
小水	xiao shui
小题	xiao ti
效越烟次	xiao yue yan ci
鸭子	ya zi
烟次	yan ci
蚁暮琵琶	yi mu pi pa
医上道定	yi shang dao ding
蚁食	yi shi
影缝余弦	ying feng yu xian
影缝余弦的式神	ying feng yu xian de shi shen
羽川翼	yu chuan yi
余来承继	yu lai cheng ji
猿猴之手	yuan hou zhi shou
战场原黑仪	zhan chang yuan hei yi
雉切帆河	zhi qie fan he
终物语	zhong wu yu
周囲通魔	zhou wei tong mo
足根敬离	zu gen jing li