暗器黑演舞	an qi hei yan wu
暗杀破戒僧	an sha po jie seng
岸涯小僧	an ya xiao seng
鏖地藏	ao di zang
八十八鬼夜行	ba shi ba gui ye xing
八十流凭鬼术	ba shi liu ping gui shu
魃战乙女演舞	ba zhan yi nv yan wu
白藏主	bai cang zhu
百鬼夜行	bai gui ye xing
百物语组	bai wu yu zu
比叡山	bi rui shan
冰丽	bing li
仓田	cang tian
茶枳尼	cha zhi ni
常州的弦杀师	chang zhou de xian sha shi
赤河童	chi he tong
魑魅魍魉之主	chi mei wang liang zhi zhu
创造式神使	chuang zao shi shen shi
茨木童子	ci mu tong zi
大天狗	da tian gou
大猿狒狒的大太刀	da yuan fei fei de da tai dao
代纹	dai wen
淡岛	dan dao
岛二郎	dao er lang
东北远野	dong bei yuan ye
二十七面千手百足	er shi qi mian qian shou bai zu
二条城	er tiao cheng
二尾之铁扇	er wei zhi tie shan
狒狒	fei fei
狒狒组	fei fei zu
风声鹤唳	feng sheng he li
伏见稻荷大社	fu jian dao he da she
浮世绘町	fu shi hui ding
刚力礼赞	gang li li zan
关东大猿会	guan dong da yuan hui
鬼缠	gui chan
鬼缠毒羽	gui chan du yu
鬼缠明镜止水百火撩乱	gui chan ming jing zhi shui bai huo liao luan
鬼缠浓红大申爪	gui chan nong hong da shen zhao
鬼缠畏炮流星天下	gui chan wei pao liu xing tian xia
鬼缠袭色紫菀之镰	gui chan xi se zi wan zhi lian
鬼缠雪下红梅	gui chan xue xia hong mei
桂离宫	gui li gong
鬼神之凭完全父性伊奘诺	gui shen zhi ping wan quan fu xing yi zang nuo
鬼童丸	gui tong wan
河童	he tong
河童忍法秘传	he tong ren fa mi chuan
河童忍法秘传蛟虬球	he tong ren fa mi chuan jiao qiu qiu
河童忍法通道忍池	he tong ren fa tong dao ren chi
黑田坊	hei tian fang
黑羽丸	hei yu wan
花开院	hua kai yuan
花开院布	hua kai yuan bu
花开院分家爱华流	hua kai yuan fen jia ai hua liu
花开院分家八十流	hua kai yuan fen jia ba shi liu
花开院分家福寿流	hua kai yuan fen jia fu shou liu
花开院豪罗	hua kai yuan hao luo
花开院灰吾	hua kai yuan hui wu
花开院龙二	hua kai yuan long er
花开院破户	hua kai yuan po hu
花开院秋房	hua kai yuan qiu fang
花开院是人	hua kai yuan shi ren
花开院秀尔	hua kai yuan xiu er
花开院秀元	hua kai yuan xiu yuan
花开院雅次	hua kai yuan ya ci
花开院柚罗	hua kai yuan you luo
滑头鬼	hua tou gui
滑头鬼之孙	hua tou gui zhi sun
滑头鬼之孙千年魔京	hua tou gui zhi sun qian nian mo jing
幻夜行	huan ye xing
荒骷髅	huang ku lou
黄色虹膜	huang se hong mo
火间虫入道	huo jian chong ru dao
及川冰丽	ji chuan bing li
鸡冠丸	ji guan wan
纪乃	ji nai
家长加奈	jia zhang jia nai
菅沼定盛	jian zhao ding sheng
金生水	jin sheng shui
金生水之花	jin sheng shui zhi hua
金生水之流星	jin sheng shui zhi liu xing
金生水之阵	jin sheng shui zhi zhen
镜花水月	jing hua shui yue
经立之土彦	jing li zhi tu yan
卷沙织	juan sha zhi
凯郎太	kai lang tai
可怜竟无子一粒	ke lian jing wu zi yi li
狂骨	kuang gu
镰鼬之铸铎	lian you zhi zhu duo
捩眼山	lie yan shan
凌罗魔斩	ling luo mo zhan
柳田	liu tian
龙安寺	long an si
蝼蛄众	lou gu zhong
陆生	lu sheng
鹿苑寺	lu yuan si
乱发游女之舞	luan fa you nv zhi wu
络新妇	luo xin fu
马头丸	ma tou wan
毛倡妓	mao chang ji
梅若丸	mei ruo wan
弥弥切丸	mi mi qie wan
明镜止水	ming jing zhi shui
明镜止水樱	ming jing zhi shui ying
魔魅流	mo mei liu
纳豆小僧	na dou xiao seng
鸟居夏实	niao ju xia shi
牛鬼	niu gui
牛头丸	niu tou wan
牛头阴魔爪	niu tou yin mo zhao
奴良滑瓢	nu liang hua piao
奴良家一脉相传无回转黑道飞踢	nu liang jia yi mai xiang chuan wu hui zhuan hei dao fei ti
奴良家一子相传无用妖怪退散踢	nu liang jia yi zi xiang chuan wu yong yao guai tui san ti
奴良鲤伴	nu liang li ban
奴良陆生	nu liang lu sheng
奴良若菜	nu liang ruo cai
奴良组	nu liang zu
琵琶湖	pi pa hu
凭鬼枪	ping gui qiang
七人同行	qi ren tong hang
千羽大人	qian yu da ren
切裂通路的小僧	qie lie tong lu de xiao seng
清继	qing ji
清十字	qing shi zi
清十字怪奇侦探团	qing shi zi guai qi zhen tan tuan
清十字清继	qing shi zi qing ji
清水寺	qing shui si
青田坊	qing tian fang
犬凤凰	quan feng huang
犬神	quan shen
三代目	san dai mu
三尾之太刀	san wei zhi tai dao
三羽鸦	san yu ya
杀取螺旋刃	sha qu luo xuan ren
杀取蛇行刃	sha qu she xing ren
山本五郎左卫门	shan ben wu lang zuo wei men
山吹花开七八重	shan chui hua kai qi ba zhong
山吹乙女	shan chui yi nv
少主	shao zhu
式神饿狼	shi shen e lang
式神狂言	shi shen kuang yan
式神强毛裸丸	shi shen qiang mao luo wan
式神五毛丸	shi shen wu mao wan
式神言言	shi shen yan yan
式神仰言	shi shen yang yan
首无	shou wu
手洗鬼	shou xi gui
兽之念珠	shou zhi nian zhu
水弹玉	shui dan yu
水式神	shui shi shen
四分之一的妖怪血统	si fen zhi yi de yao guai xue tong
四国	si guo
四国八十八鬼夜行	si guo ba shi ba gui ye xing
四尾之枪虎退治	si wei zhi qiang hu tui zhi
松山山口灵堂面	song shan shan kou ling tang mian
天女之凭完全母性伊奘冉	tian nv zhi ping wan quan mu xing yi zang ran
天邪鬼	tian xie gui
天邪鬼淡岛	tian xie gui dan dao
土蜘蛛	tu zhi zhu
畏的发动魃之移动凭	wei de fa dong ba zhi yi dong ping
无头鬼	wu tou gui
无用妖怪退散踢	wu yong yao guai tui san ti
五枝金花	wu zhi jin hua
西芳寺	xi fang si
弦杀杀取锁蜘蛛	xian sha sha qu suo zhi zhu
相国寺	xiang guo si
邪魅	xie mei
猩影	xing ying
秀岛藩	xiu dao fan
秀岛藩藩主菅沼定盛	xiu dao fan fan zhu jian zhao ding sheng
袖衣神	xiu yi shen
秀元	xiu yuan
雪化妆	xue hua zhuang
雪结晶	xue jie jing
雪丽	xue li
雪女冷丽	xue nv leng li
雪山杀	xue shan sha
血畏梦百鬼夜行	xue wei meng bai gui ye xing
鸦天狗	ya tian gou
言言	yan yan
妖刀八十流妖枪骑亿	yao dao ba shi liu yao qiang qi yi
妖怪少爷	yao guai shao ye
妖铭酒	yao ming jiu
鵺安倍晴明	ye an bei qing ming
夜雀	ye que
隐神刑部狸	yin shen xing bu li
珱姬	ying ji
游人鲤先生	you ren li xian sheng
羽衣狐	yu yi hu
玉章	yu zhang
远野妖怪	yuan ye yao guai
云外境	yun wai jing
战略妖塞	zhan lue yao sai
沼河童忍法泥沼地狱	zhao he tong ren fa ni zhao di yu
沼河童之雨造	zhao he tong zhi yu zao
针女	zhen nv
鸩桑	zhen sang
鸩一派	zhen yi pai
铸铎	zhu duo
竹竹美	zhu zhu mei
椎桥宽	zhui qiao kuan
总大将	zong da jiang
诅咒之吹雪	zu zhou zhi chui xue
诅咒之飘雪	zu zhou zhi piao xue