艾丽安娜羽山阿莉阿鲁迪	ai li an na yu shan a li a lu di
艾丽卡	ai li ka
艾丽卡布朗特里	ai li ka bu lang te li
艾丽卡教授	ai li ka jiao shou
爱丽丝公主	ai li si gong zhu
爱丽丝路易斯欧芙纳法尔	ai li si lu yi si ou fu na fa er
保罗布朗特里	bao luo bu lang te li
不从之神	bu cong zhi shen
布朗特里家	bu lang te li jia
草薙护堂	cao ti hu tang
草薙静花	cao ti jing hua
长枪投掷召唤狮子	chang qiang tou zhi zhao huan shi zi
赤色恶魔	chi se e mo
从属神天丛云剑	cong shu shen tian cong yun jian
狄安娜米利托	di an na mi li tuo
第八位弑神者	di ba wei shi shen zhe
第二物语	di er wu yu
第一爱人	di yi ai ren
东尼	dong ni
反町	fan ding
甘粕冬马	gan po dong ma
高木	gao mu
戈尔贡之石事件	ge er gong zhi shi shi jian
格林尼治贤人议会	ge lin ni zhi xian ren yi hui
邯郸之梦	han dan zhi meng
赫耳墨斯的长靴	he er mo si de chang xue
红之恶魔	hong zhi e mo
花泽香菜	hua ze xiang cai
黄金之剑	huang jin zhi jian
惠那	hui na
剑之巫女	jian zhi wu nv
剑之妖精	jian zhi yao jing
解除剑伪装	jie chu jian wei zhuang
杰克米尔本	jie ke mi er ben
杰里科的歼灭	jie li ke de jian mie
静花	jing hua
九法冢家	jiu fa zhong jia
究极的大和抚子	jiu ji de da he fu zi
军神韦勒斯拉纳	jun shen wei le si la na
莱茵哈特	lai yin ha te
莉莉娅娜克兰尼查尔	li li ya na ke lan ni cha er
连城冬姬	lian cheng dong ji
瑠伟	liu wei
露库拉齐亚佐拉	lu ku la qi ya zuo la
梅尔	mei er
米甸的歼灭	mi dian de jian mie
名波	ming bo
魔术结社赤铜黑十字	mo shu jie she chi tong hei shi zi
魔术结社青铜黒十字	mo shu jie she qing tong hei shi zi
魔王来临	mo wang lai lin
南洋之姬神	nan yang zhi ji shen
女神再临	nv shen zai lin
女神之子	nv shen zhi zi
破碎后召唤狮子	po sui hou zhao huan shi zi
漆黑交织战衣的圣骑士	qi hei jiao zhi zhan yi de sheng qi shi
齐藤佑圭	qi teng you gui
齐天大圣	qi tian da sheng
枪之战神	qiang zhi zhan shen
顷刻的圣诞夜	qing ke de sheng dan ye
清秋院惠那	qing qiu yuan hui na
青铜黑十字	qing tong hei shi zi
权能东方之战神	quan neng dong fang zhi zhan shen
日笠阳子	ri li yang zi
萨丁岛的魔女	sa ding dao de mo nv
萨特纳利亚之冠的神之灵魂	sa te na li ya zhi guan de shen zhi ling hun
三浦	san pu
沙耶宫馨	sha ye gong xin
神不值得信奉	shen bu zhi de xin feng
神山飞凤	shen shan fei feng
神祖格维尼亚	shen zu ge wei ni ya
噬神者	shi shen zhe
受难的魔王们	shou nan de mo wang men
松冈祯丞	song gang zhen cheng
速须佐之男命咒歌	su xu zuo zhi nan ming zhou ge
素盏鸣尊	su zhan ming zun
天丛云剑	tian cong yun jian
万里谷光	wan li gu guang
万里谷佑理	wan li gu you li
王的晚餐会	wang de wan can hui
王者游戏	wang zhe you xi
物语的开始	wu yu de kai shi
喜多村英梨	xi duo cun ying li
夜叉的微笑	ye cha de wei xiao
一个人的骑士	yi ge ren de qi shi
英雄与王	ying xiong yu wang
佑理	you li
媛巫女	yuan wu nv
詹纳罗甘兹	zhan na luo gan zi
中山	zhong shan
最高骑士称号	zui gao qi shi cheng hao