步步惊情	bu bu jing qing
步步惊心	bu bu jing xin
错点鸳鸯	cuo dian yuan yang
杜鹃之巢	du juan zhi chao
古剑奇谭	gu jian qi tan
花非花雾非雾	hua fei hua wu fei wu
加油爱人	jia you ai ren
金玉良缘	jin yu liang yuan
来自星星的你	lai zi xing xing de ni
秘密花园	mi mi hua yuan
穆桂英挂帅	mu gui ying gua shuai
死神少女	si shen shao nv
天天有喜	tian tian you xi
王的女人	wang de nv ren
我的女友是九尾狐	wo de nv you shi jiu wei hu
屋塔房王世子	wu ta fang wang shi zi
犀利仁师	xi li ren shi
相爱十年	xiang ai shi nian
笑傲江湖	xiao ao jiang hu
轩辕剑	xuan yuan jian