大冢芳忠	da zhong fang zhong
渡边	du bian
逢坂良太	feng ban liang tai
福山润	fu shan run
宫野真守	gong ye zhen shou
海斗	hai dou
户崎	hu qi
木下浩之	mu xia hao zhi
平川大辅	ping chuan da fu
田中功次	tian zhong gong ci
梶裕贵	wei yu gui
细谷佳正	xi gu jia zheng
下村泉	xia cun quan
小仓郁也	xiao cang yu ye
小松未可子	xiao song wei ke zi
亚人	ya ren
樱井孝宏	ying jing xiao hong
永井圭	yong jing gui
永井圭之母	yong jing gui zhi mu
永井慧理子	yong jing hui li zi
泽海阳子	ze hai yang zi
中村慎也	zhong cun shen ye
中村慎也事件	zhong cun shen ye shi jian
中岛启介	zhong dao qi jie
中野攻	zhong ye gong
洲崎绫	zhou qi ling
佐藤	zuo teng