爱上桃子的傻阿狸	ai shang tao zi de sha a li
半路十年	ban lu shi nian
等你一个青春	deng ni yi ge qing chun
风流特种兵混都市	feng liu te zhong bing hun du shi
枫枼	feng ye
果壳小说网	guo ke xiao shuo wang
欢颜如梦	huan yan ru meng
黄逗	huang dou
皇上本宫不干皇后了滚	huang shang ben gong bu gan huang hou le gun
来迟	lai chi
林小白	lin xiao bai
珞喵珞	luo miao luo
慢动作	man dong zuo
魔天游峰	mo tian you feng
墨矽颜	mo xi yan
莫须莠	mo xu you
逆武八荒	ni wu ba huang
虐恋	nue lian
普渡	pu du
青春毁不去流年	qing chun hui bu qu liu nian
青琦	qing qi
三色楼	san se lou
森息	sen xi
商裳	shang shang
网游之朝歌天下	wang you zhi zhao ge tian xia
维也纳的梨花雨	wei ye na de li hua yu
小虎少爷	xiao hu shao ye
小落花	xiao luo hua
筱希	xiao xi
谢谢你陪我颠沛流离	xie xie ni pei wo dian pei liu li
一笑倾城	yi xiao qing cheng
一直都这样	yi zhi dou zhe yang
虞美人	yu mei ren
缘字诀断肠今世	yuan zi jue duan chang jin shi
月恒	yue heng
烛燕	zhu yan