阿耳忒弥斯	a er tei mi si
伯纳德	bo na de
赤腕佣兵团	chi wan yong bing tuan
纯洁的玛利亚	chun jie de ma li ya
岛田敏	dao tian min
花江夏树	hua jiang xia shu
花泽香菜	hua ze xiang cai
吉尔伯特	ji er bo te
纪尧姆	ji yao mu
迦尔法	jia er fa
加隈亚衣	jia wei ya yi
金元寿子	jin yuan shou zi
鲁梅伯纪尧姆	lu mei bo ji yao mu
罗洛特	luo luo te
玛利亚	ma li ya
玛丽亚森林	ma li ya sen lin
玛莎	ma sha
米迦勒	mi jia le
能登麻美子	neng deng ma mei zi
普里阿普斯	pu li a pu si
日笠阳子	ri li yang zi
三宅健太	san zhai jian tai
圣母	sheng mu
维弗	wei fu
温彻斯特	wen che si te
小岛幸子	xiao dao xing zi
小松未可子	xiao song wei ke zi
小野贤章	xiao ye xian zhang
小野友树	xiao ye you shu
一城美由希	yi cheng mei you xi
伊万	yi wan
以西结	yi xi jie
樱井孝宏	ying jing xiao hong
约瑟夫	yue se fu