背叛者知我名	bei pan zhe zhi wo ming
背叛知道我的名字	bei pan zhi dao wo de ming zi
布兰德	bu lan de
愁生	chou sheng
椿姬	chun ji
丛雨	cong yu
丛雨九十九	cong yu jiu shi jiu
丛雨十瑚	cong yu shi hu
冬解	dong jie
碓冰	dui bing
碓氷	dui bing
碓冰愁生	dui bing chou sheng
碓氷愁生	dui bing chou sheng
防卫墙	fang wei qiang
光与绝望的分界	guang yu jue wang de fen jie
黑刀	hei dao
黄昏馆	huang hun guan
黄泉的落日	huang quan de luo ri
江秦	jiang qin
江秦芽华	jiang qin ya hua
降织	jiang zhi
降织千紫郎	jiang zhi qian zi lang
降织伽蓝	jiang zhi qie lan
戒之手	jie zhi shou
九十九	jiu shi jiu
克己	ke ji
库洛斯桀利亚	ku luo si jie li ya
拉杰艾尔之键	la jie ai er zhi jian
黎那	li na
裏切仆名前知	li qie pu ming qian zhi
莲城	lian cheng
莲城焰椎真	lian cheng yan zhui zhen
泠呀	ling ya
鲁卡	lu ka
路卡	lu qia
弥凉	mi liang
魔王之血十字架	mo wang zhi xue shi zi jia
奈落	nai luo
蓬莱	peng lai
蓬莱黑刀	peng lai hei dao
千紫郎	qian zi lang
泉摩利学园	quan mo li xue yuan
若宫	ruo gong
若宫奏多	ruo gong zou duo
丧钟	sang zhong
神技	shen ji
神命	shen ming
神命斎俐	shen ming zhai li
神命正宗	shen ming zheng zong
神之耳	shen zhi er
神之光	shen zhi guang
神之灵石	shen zhi ling shi
神之声	shen zhi sheng
神之眼	shen zhi yan
神之足	shen zhi zu
圣护盾	sheng hu dun
式部	shi bu
式部椿姬	shi bu chun ji
式部观月	shi bu guan yue
式部为吹	shi bu wei chui
十瑚	shi hu
时间流转	shi jian liu zhuan
死神之镰	si shen zhi lian
索多姆	suo duo mu
藤原	teng yuan
藤原弥凉	teng yuan mi liang
天白	tian bai
瓦尔普吉斯之夜	wa er pu ji si zhi ye
为吹	wei chui
沃尔帕吉斯之夜	wo er pa ji si zhi ye
我知道我的名字是背叛者	wo zhi dao wo de ming zi shi bei pan zhe
无法逃离的背叛	wu fa tao li de bei pan
无法挽回的日子	wu fa wan hui de ri zi
吴羽	wu yu
吴羽冬解	wu yu dong jie
吴羽绫	wu yu ling
夕月	xi yue
夕月之链	xi yue zhi lian
小田切萤	xiao tian qie ying
新的邂逅	xin de xie hou
血色十字架	xue se shi zi jia
血之印	xue zhi yin
芽华	ya hua
焰椎真	yan zhui zhen
耀眼的明日	yao yan de ming ri
乙抚莉亚	yi fu li ya
樱井夕月	ying jing xi yue
永恒的音调	yong heng de yin diao
由希	you xi
宇筑	yu zhu
远间	yuan jian
远间克己	yuan jian ke ji
泽斯	ze si
召魔书	zhao mo shu
朝阳院	zhao yang yuan
正体不明	zheng ti bu ming
正宗	zheng zong
直到没有背叛的世界	zhi dao mei you bei pan de shi jie
祗王	zhi wang
祗王橘	zhi wang ju
祗王泠呀	zhi wang ling ya
祗王天白	zhi wang tian bai
祗王夕月	zhi wang xi yue
祗王一族	zhi wang yi zu
终焉之盾	zhong yan zhi dun
奏多	zou duo
罪孽深重的血族	zui nie shen zhong de xue zu
罪与罚	zui yu fa