阿剌克涅族	a la ke nie zu
半人半蛇的亚人种拉米娅族	ban ren ban she de ya ren zhong la mi ya zu
博尔特	bo er te
波尔特	bo er te
杜拉罕族	du la han zu
独眼族女孩	du yan zu nv hai
多倍尔	duo bei er
多拉克	duo la ke
多佩尔	duo pei er
恶魔族	e mo zu
哈皮族	ha pi zu
家主大人	jia zhu da ren
僵尸娜	jiang shi na
九菜月莲	jiu cai yue lian
九菜月连	jiu cai yue lian
拉克涅拉	la ke nie la
拉克涅拉阿拉克涅拉	la ke nie la a la ke nie la
拉克瑞娜	la ke rui na
拉拉	la la
来留主公人	lai liu zhu gong ren
莉莉丝	li li si
龙人族	long ren zu
裸族	luo zu
马娜可	ma na ke
梅洛	mei luo
美洛	mei luo
美洛努罗蕾莱	mei luo nu luo lei lai
米亚	mi ya
冥界骑士	ming jie qi shi
魔物娘的同居日常	mo wu niang de tong ju ri chang
墨须	mo xu
帕比	pa bi
帕皮	pa pi
人马娘	ren ma niang
人鱼公主	ren yu gong zhu
人鱼族	ren yu zu
赛蕾娅	sai lei ya
珊卓雷雅	shan zhuo lei ya
珊卓雷雅夏努	shan zhuo lei ya xia nu
食人魔族	shi ren mo zu
树妖族	shu yao zu
提奥尼西亚	ti ao ni xi ya
提欧尼西亚	ti ou ni xi ya
无头骑士族	wu tou qi shi zu
蜥蜴人族	xi yi ren zu
鹰身人娘	ying shen ren niang
真奈子	zhen nai zi
蜘蛛女	zhi zhu nv
种族间交流法	zhong zu jian jiao liu fa
奏比娜	zou bi na