长妻树里	chang qi shu li
大龟明日香	da gui ming ri xiang
町子凉	ding zi liang
町子明	ding zi ming
井口裕香	jing kou yu xiang
露子	lu zi
米谷美咲	mi gu mei xiao
内木由纪	nei mu you ji
麒麟	qi lin
千菅春香	qian jian chun xiang
森野麒麟	sen ye qi lin
山崎阳菜	shan qi yang cai
土田芽生	tu tian ya sheng
西明日香	xi ming ri xiang
小林优	xiao lin you
小松未可子	xiao song wei ke zi
幸腹涂鸦	xing fu tu ya
芽生	ya sheng
阳菜	yang cai
野中蓝	ye zhong lan
预科学校	yu ke xue xiao
椎名	zhui ming
佐藤利奈	zuo teng li nai