安陪恭加	an pei gong jia
本村碧唯	ben cun bi wei
村重杏奈	cun zhong xing nai
儿玉遥	er yu yao
宫脇咲良	gong xie xiao liang
谷口爱理	gu kou ai li
古森结衣	gu sen jie yi
菅本裕子	jian ben yu zi
江藤彩也香	jiang teng cai ye xiang
今田美奈	jin tian mei nai
若田部遥	ruo tian bu yao
森保圆	sen bao yuan
深川舞子	shen chuan wu zi
松冈菜摘	song gang cai zhai
田中奈津美	tian zhong nai jin mei
下野由贵	xia ye you gui
熊泽世莉奈	xiong ze shi li nai
穴井千寻	xue jing qian xun
植木南央	zhi mu nan yang
仲西彩佳	zhong xi cai jia
中西智代梨	zhong xi zhi dai li