阿尔玛托兰	a er ma tuo lan
阿拉丁	a la ding
阿勒奇乌斯	a le qi wu si
阿里巴巴	a li ba ba
阿蒙	a meng
埃尔萨梅	ai er sa mei
艾尔缇谬拉	ai er ti miu la
暗黑大陆	an hei da lu
闇技	an ji
闇体	an ti
闇心	an xin
巴巴托斯	ba ba tuo si
巴尔巴德	ba er ba de
八芳星	ba fang xing
巴拉拉	ba la la
巴力	ba li
八人将	ba ren jiang
拜恩	bai en
拜帕	bai pa
毕仑	bi lun
布迪尔	bu di er
布松	bu song
成加	cheng jia
多拉公	duo la gong
多鲁吉	duo lu ji
朵妮雅	duo ni ya
法丁马	fa ding ma
法纳利斯	fa na li si
法纳利斯兵团	fa na li si bing tuan
风裂斩	feng lie zhan
弗法	fu fa
弗加洛	fu jia luo
哥鲁达斯	ge lu da si
哈利奥巴布德	ha li ao ba bu de
黑磁枪	hei ci qiang
黑光球	hei guang qiu
华利弗	hua li fu
华影阵	hua ying zhen
煌帝国	huang di guo
黄牙	huang ya
极大魔法	ji da mo fa
迦尔鲁卡	jia er lu ka
贾法尔	jia fa er
贾米尔	jia mi er
桀派	jie pai
金刚铁甲	jin gang tie jia
金属器	jin shu qi
眷属器	juan shu qi
卡达葛	ka da ge
卡门	ka men
卡西姆	ka xi mu
克罗塞尔	ke luo sai er
莱拉	lai la
雷光剑	lei guang jian
雷姆帝国	lei mu di guo
李青舜	li qing shun
练白龙	lian bai long
练白瑛	lian bai ying
练红霸	lian hong ba
练红明	lian hong ming
练红炎	lian hong yan
练红玉	lian hong yu
练玉艳	lian yu yan
裸王	luo wang
吕斋	lv zhai
马格诺修泰德	ma ge nuo xiu tai de
玛莉阿姆	ma li a mu
麻麻	ma ma
马斯鲁尔	ma si lu er
玛塔路	ma ta lu
迷宫攻略者	mi gong gong lue zhe
魔导士	mo dao shi
摩尔迦娜	mo er jia na
魔法道具	mo fa dao ju
莫迦梅特	mo jia mei te
魔神	mo shen
魔神的金属器	mo shen de jin shu qi
穆斯塔西姆	mu si ta xi mu
帕鲁提比亚	pa lu ti bi ya
派蒙	pai meng
皮斯缇	pi si ti
七海联盟	qi hai lian meng
七海种马	qi hai zhong ma
千手回转	qian shou hui zhuan
裘达尔	qiu da er
裘大撸	qiu da lu
萨桑	sa sang
萨沙	sa sha
赛共	sai gong
沙尔贾	sha er jia
莎赫扎德	sha he zha de
沙克斯	sha ke si
沙曼	sha man
神无手旋回	shen wu shou xuan hui
双蛇镖	shuang she biao
斯芬托斯	si fen tuo si
斯帕尔多斯	si pa er duo si
缇特斯	ti te si
托娃	tuo wa
乌戈君	wu ge jun
席纳霍霍	xi na huo huo
夏巴鲁	xia ba lu
夏黄文	xia huang wen
夏露露	xia lu lu
辛巴德	xin ba de
辛德利亚	xin de li ya
雅姆莱哈	ya mu lai ha
阳巴剌	yang ba la
叶王	ye wang
伊姆查克	yi mu cha ke
伊萨亚克	yi sa ya ke
伊苏南	yi su nan
银行屋	yin hang wu
尤纳恩	you na en
支乡	zhi xiang
祖鲁姆德	zu lu mu de