博德牧羊犬	bo de mu yang quan
补习大学堂	bu xi da xue tang
仓木麻衣	cang mu ma yi
仓木麻衣国际应援站	cang mu ma yi guo ji ying yuan zhan
产业社会学部	chan ye she hui xue bu
产业社会学科	chan ye she hui xue ke
船桥市立前原小学	chuan qiao shi li qian yuan xiao xue
岛呗	dao bei
动漫游戏店	dong man you xi dian
豆面酱汁	dou mian jiang zhi
豆面酱煮鲭鱼	dou mian jiang zhu qing yu
饭团	fan tuan
芳香按摩	fang xiang an mo
扶桑花	fu sang hua
富士八郎	fu shi ba lang
歌词秘藏室	ge ci mi cang shi
海岸布告栏	hai an bu gao lan
海上服务处	hai shang fu wu chu
火锅	huo guo
精品小厨	jing pin xiao chu
克里斯蒂安来易斯拉森	ke li si di an lai yi si la sen
矿物泥负离子机	kuang wu ni fu li zi ji
立命馆大学	li ming guan da xue
立命馆宇治高等学校	li ming guan yu zhi gao deng xue xiao
戀衣株式會社	lian yi zhu shi kuai she
麻衣	ma yi
麻衣档案馆	ma yi dang an guan
麻衣航海日志	ma yi hang hai ri zhi
芒果锉冰	mang guo cuo bing
梅格瑞恩	mei ge rui en
名侦探柯南	ming zhen tan ke nan
纳豆	na dou
平成歌姬仓木麻衣	ping cheng ge ji cang mu ma yi
情窦女性淡香水	qing dou nv xing dan xiang shui
青野公子	qing ye gong zi
青野拓也	qing ye tuo ye
青野真衣	qing ye zhen yi
人间文化学系	ren jian wen hua xue xi
日本音乐料理店	ri ben yin yue liao li dian
山前実治	shan qian shi zhi
山前五十洋	shan qian wu shi yang
圣德大学附属中学高等女子学校	sheng de da xue fu shu zhong xue gao deng nv zi xue xiao
生活大讲堂	sheng huo da jiang tang
食材外卖	shi cai wai mai
视觉盛宴	shi jue sheng yan
数码实验室	shu ma shi yan shi
水果	shui guo
顺其自然	shun qi zi ran
搜寻地方特产	sou xun di fang te chan
体育健身房	ti yu jian shen fang
天籁之音	tian lai zhi yin
唯衣	wei yi
西瓜	xi gua
夏目漱石	xia mu shu shi
写真展览厅	xie zhen zhan lan ting
新光美音多媒体有限公司	xin guang mei yin duo mei ti you xian gong si
旋律香槟	xuan lv xiang bin
衣吧	yi ba
意大利面	yi da li mian
衣盟	yi meng
衣迷	yi mi
衣迷招待舱	yi mi zhao dai cang
衣协	yi xie
衣衣不舍	yi yi bu she
衣之海岸	yi zhi hai an
印度料理	yin du liao li
柚子	you zi
玉米沙拉	yu mi sha la
原创道场	yuan chuang dao chang
约翰尼德普	yue han ni de pu