阿羡	a xian
陈情令	chen qing ling
创造	chuang zao
斗罗大陆	dou luo da lu
方天泽	fang tian ze
顾魏	gu wei
克卜勒	ke bu le
狼殿下	lang dian xia
满足	man zu
你是我此生最美的风景	ni shi wo ci sheng zui mei de feng jing
哦我的皇帝陛下	o wo de huang di bi xia
曲尽陈情	qu jin chen qing
尚好的青春	shang hao de qing chun
唐三	tang san
兔牙	tu ya
魏无羡	wei wu xian
我们的歌	wo men de ge
羡羡	xian xian
肖八分	xiao ba fen
小飞侠	xiao fei xia
肖美人	xiao mei ren
肖兔子	xiao tu zi
小王子	xiao wang zi
肖肖	xiao xiao
小赞	xiao zan
小战	xiao zhan
肖战	xiao zhan
有钱哥哥	you qian ge ge
余生请多指教	yu sheng qing duo zhi jiao
赞比	zan bi
战哥	zhan ge
战战	zhan zhan
张小凡	zhang xiao fan
主唱	zhu chang
诛仙	zhu xian