阿雅	a ya
艾亮	ai liang
矮马	ai ma
槟榔妹	bing lang mei
不要忘记我爱你	bu yao wang ji wo ai ni
宠物医院	chong wu yi yuan
宠物诊所	chong wu zhen suo
德牧	de mu
丁涵	ding han
鬼马亮亮	gui ma liang liang
郭碧婷	guo bi ting
哈士奇	ha shi qi
红小胖	hong xiao pang
花姐	hua jie
贾长安	jia chang an
金世佳	jin shi jia
拉布拉多	la bu la duo
拉布拉多犬	la bu la duo quan
乐乐	le le
李一情	li yi qing
亮亮	liang liang
灵缇	ling ti
刘倩文	liu qian wen
吕一丹	lv yi dan
孟达	meng da
牧羊犬	mu yang quan
彭博	peng bo
神犬	shen quan
神犬小七	shen quan xiao qi
兽医	shou yi
兽医资格证	shou yi zi ge zheng
佟瑞	tong rui
王路	wang lu
王洋	wang yang
王煜	wang yu
香猪	xiang zhu
小米	xiao mi
小明	xiao ming
小七	xiao qi
小五	xiao wu
丫丫	ya ya
羊驼	yang tuo
医生	yi sheng
鹦鹉	ying wu
于飞	yu fei
袁大壮	yuan da zhuang
张柏嘉	zhang bai jia
朱佳煜	zhu jia yu