鲍雯佳	bao wen jia
陈慕义	chen mu yi
陈晓东	chen xiao dong
邓紫棋	deng zi qi
傅晓娜	fu xiao na
高宏量	gao hong liang
胡彩虹	hu cai hong
金泽灏	jin ze hao
李黎	li li
毛林林	mao lin lin
钱志	qian zhi
沈昳	shen yi
孙骁骁	sun xiao xiao
唐艺昕	tang yi xin
田淼	tian miao
王希维	wang xi wei
徐正曦	xu zheng xi
杨贵媚	yang gui mei
杨志雯	yang zhi wen
张逸杰	zhang yi jie
张一龙	zhang yi long
张籽沐	zhang zi mu
周丹薇	zhou dan wei