爱不得	ai bu de
爱我想爱的人	ai wo xiang ai de ren
鏖战	ao zhan
陈莫	chen mo
晨曦	chen xi
陈曦	chen xi
崔西	cui xi
打车软件	da che ruan jian
董冬冬	dong dong dong
飞总	fei zong
高级谈判专家	gao ji tan pan zhuan jia
郭品超	guo pin chao
胡迪	hu di
黄子韬	huang zi tao
季冠霖	ji guan lin
机智御姐	ji zhi yu jie
蒋可	jiang ke
快闪	kuai shan
赖艺	lai yi
李婷婷	li ting ting
连凯	lian kai
龙政璇	long zheng xuan
盲目自信	mang mu zi xin
毛嘉明	mao jia ming
毛林林	mao lin lin
魔性初遇	mo xing chu yu
暖心招数	nuan xin zhao shu
女谈判官	nv tan pan guan
琪琪	qi qi
齐如海	qi ru hai
秦天宇	qin tian yu
拳击美少女	quan ji mei shao nv
商碧晨	shang bi chen
商务谈判	shang wu tan pan
商业巨头	shang ye ju tou
世界为你转身	shi jie wei ni zhuan shen
史文翔	shi wen xiang
司徒志高	si tu zhi gao
孙伯纶	sun bo lun
孙昊	sun hao
谈判法则	tan pan fa ze
谈判晋级	tan pan jin ji
谈判谈心	tan pan tan xin
体温牛奶	ti wen niu nai
童大佬	tong da lao
童恬恬	tong tian tian
童薇	tong wei
童薇小姐姐	tong wei xiao jie jie
脱单预言家	tuo dan yu yan jia
夏杉杉	xia shan shan
晓飞	xiao fei
肖翔	xiao xiang
小幸福	xiao xing fu
谢天佑	xie tian you
谢晓飞	xie xiao fei
谢晓天	xie xiao tian
新人菜鸟	xin ren cai niao
新时代精英	xin shi dai jing ying
杨菲洋	yang fei yang
杨幂	yang mi
杨天翔	yang tian xiang
杨潇	yang xiao
于永海	yu yong hai
张磊	zhang lei
张喆	zhang zhe
赵晨曦	zhao chen xi
赵楚纶	zhao chu lun
赵文瑄	zhao wen xuan
职场小白兔	zhi chang xiao bai tu
主动求变理论	zhu dong qiu bian li lun
祝绪丹	zhu xu dan
自由系反套路	zi you xi fan tao lu