戴孚	dai fu
古董收藏家	gu dong shou cang jia
关皮皮	guan pi pi
广异记	guang yi ji
贺兰大人	he lan da ren
何蓝逗	he lan dou
贺兰静霆	he lan jing ting
贺兰觽	he lan wei
狐族	hu zu
黄景瑜	huang jing yu
江奇霖	jiang qi lin
结爱	jie ai
宽永	kuan yong
李嘉铭	li jia ming
李燊	li shen
刘奇	liu qi
刘泳希	liu yong xi
千花	qian hua
少年宽永	shao nian kuan yong
少年修鹇	shao nian xiu xian
少女慧颜	shao nv hui yan
施定柔	shi ding rou
宋秉洋	song bing yang
宋茜	song qian
随从	sui cong
陶家麟	tao jia lin
天狐星	tian hu xing
田欣	tian xin
涂山千花	tu shan qian hua
小菊	xiao ju
辛小菊	xin xiao ju
修鹇	xiu xian
许芳铱	xu fang yi
徐开骋	xu kai cheng
一眼千恋	yi yan qian lian
右祭祀	you ji si
于战江	yu zhan jiang
张柏嘉	zhang bai jia
赵松	zhao song
郑伟	zheng wei
朱雀街	zhu que jie
左祭司	zuo ji si