艾超	ai chao
埃及手	ai ji shou
爆爆	bao bao
北京舞佳舞	bei jing wu jia wu
北舞堂	bei wu tang
并脚托马斯	bing jiao tuo ma si
波子	bo zi
草鱼	cao yu
陈伟霆	chen wei ting
成都星空间	cheng du xing kong jian
城市编舞	cheng shi bian wu
大饼	da bing
大地板	da di ban
大回环	da hui huan
大毛	da mao
大招	da zhao
戴明	dai ming
单手踩单车	dan shou cai dan che
单手跳	dan shou tiao
倒立	dao li
倒立吊腰	dao li diao yao
邓翔	deng xiang
地板步	di ban bu
电流	dian liu
吊腰	diao yao
丁丁	ding ding
定格	ding ge
动作重复	dong zuo chong fu
对战	dui zhan
翻滚	fan gun
飞机撑	fei ji cheng
飞机转	fei ji zhuan
风车	feng che
风车动作	feng che dong zuo
风格	feng ge
冯正	feng zheng
复古街舞	fu gu jie wu
高泰	gao tai
给手	gei shou
公孙无名	gong sun wu ming
鼓点	gu dian
浩室舞	hao shi wu
鹤立	he li
何一枫	he yi feng
黄潇	huang xiao
肌肉爆震	ji rou bao zhen
肌肉震动	ji rou zhen dong
机械舞	ji xie wu
嘉禾舞社	jia he wu she
肩撑	jian cheng
经伟	jing wei
九条街	jiu tiao jie
爵士舞	jue shi wu
狂派舞	kuang pai wu
拉拉韧带	la la ren dai
雷鬼舞	lei gui wu
李悦莎莎	li yue sha sha
灵舞竞壹	ling wu jing yi
刘隽	liu juan
刘芯延	liu xin yan
鹿晗	lu han
卢舞	lu wu
律动	lv dong
慢动作	man dong zuo
孟佳	meng jia
蜜蜂少女队	mi feng shao nv dui
耐克	nai ke
诺诺	nuo nuo
女神风车	nv shen feng che
抛木	pao mu
碰撞	peng zhuang
霹雳舞	pi li wu
千千	qian qian
秦煜	qin yu
热血召集人	re xue zhao ji ren
三角撑	san jiao cheng
石帅	shi shuai
舒服姐	shu fu jie
刷头风车	shua tou feng che
甩手舞	shuai shou wu
宋茜	song qian
苏恋雅	su lian ya
锁舞	suo wu
抬腰	tai yao
腾仔	teng zai
头顶	tou ding
头转	tou zhuan
兔子	tu zi
陀螺风车	tuo luo feng che
托马斯	tuo ma si
托马斯旋转	tuo ma si xuan zhuan
万晴心	wan qing xin
王嘉尔	wang jia er
围圈跳舞	wei quan tiao wu
舞邦	wu bang
吴迪	wu di
无手风车	wu shou feng che
嘻哈	xi ha
嘻哈舞	xi ha wu
小地板	xiao di ban
小回环	xiao hui huan
肖杰	xiao jie
小孟	xiao meng
新派	xin pai
星舞忠	xing wu zhong
旋转手腕	xuan zhuan shou wan
压腿	ya tui
压压韧带	ya ya ren dai
杨凯	yang kai
杨铁锤	yang tie chui
摇滚步	yao gun bu
有范儿	you fan er
优我女团	you wo nv tuan
炸场	zha chang
招败了	zhao bai le
召集人	zhao ji ren
招数	zhao shu
赵毅	zhao yi
指耳朵	zhi er duo
转瓶子	zhuan ping zi