白石	bai shi
白石藏之介	bai shi cang zhi jie
比吕士	bi lv shi
冰帝	bing di
不动峰	bu dong feng
不二	bu er
不二裕太	bu er yu tai
不二周助	bu er zhou zhu
财前光	cai qian guang
彩友	cai you
彩友枝纯	cai you zhi chun
长太郎	chang tai lang
赤也	chi ye
赤泽	chi ze
赤泽吉朗	chi ze ji lang
春风	chun feng
慈郎	ci lang
大石	da shi
大石秀一郎	da shi xiu yi lang
稻吉	dao ji
荻之介	di zhi jie
东方	dong fang
东方雅美	dong fang ya mei
凤长太郎	feng chang tai lang
观月	guan yue
观月初	guan yue chu
国光	guo guang
海堂	hai tang
海堂薰	hai tang xun
和菜	he cai
河村	he cun
和村嘉	he cun jia
和村嘉友惠	he cun jia you hui
河村隆	he cun long
黑羽	hei yu
黑羽春风	hei yu chun feng
虎次郎	hu ci lang
胡狼桑原	hu lang sang yuan
桦地	hua di
桦地崇弘	hua di chong hong
迹部	ji bu
迹部景吾	ji bu jing wu
吉朗	ji lang
甲斐裕次郎	jia fei yu ci lang
健太郎	jian tai lang
剑太郎	jian tai lang
芥川	jie chuan
芥川慈郎	jie chuan ci lang
堇菜	jin cai
金色小春	jin se xiao chun
金田	jin tian
金田一郎	jin tian yi lang
京介	jing jie
精市	jing shi
景吾	jing wu
橘桔平	ju ju ping
桔平	ju ping
菊丸	ju wan
菊丸英二	ju wan ying er
卡鲁宾	ka lu bin
葵剑太郎	kui jian tai lang
立海大	li hai da
莉绪	li xu
莲二	lian er
六角	liu jiao
柳莲二	liu lian er
柳生	liu sheng
柳生比吕士	liu sheng bi lv shi
柳惜	liu xi
泷荻之介	long di zhi jie
龙马	long ma
龙崎	long qi
龙崎樱乃	long qi ying nai
木更津	mu geng jin
木更津淳	mu geng jin chun
木更津亮	mu geng jin liang
木奈子	mu nai zi
牧杉	mu shan
牧杉莉绪	mu shan li xu
木手永四郎	mu shou yong si lang
南健太郎	nan jian tai lang
内村	nei cun
内村京介	nei cun jing jie
朋香	peng xiang
平古场凛	ping gu chang lin
千石	qian shi
千石清纯	qian shi qing chun
千岁千里	qian sui qian li
乾贞治	qian zhen zhi
切原	qie yuan
切原赤也	qie yuan chi ye
清纯	qing chun
青学	qing xue
秋本	qiu ben
秋本柳惜	qiu ben liu xi
仁王	ren wang
仁王雅治	ren wang ya zhi
忍足	ren zu
忍足谦也	ren zu qian ye
忍足侑士	ren zu you shi
日吉	ri ji
日吉若	ri ji ruo
桑原	sang yuan
森辰德	sen chen de
山吹	shan chui
深司	shen si
神尾	shen wei
神尾明	shen wei ming
圣鲁道夫	sheng lu dao fu
市椿	shi chun
市椿秋芝	shi chun qiu zhi
十次	shi ci
室町	shi ding
室町十次	shi ding shi ci
石田	shi tian
石田铁	shi tian tie
石田银	shi tian yin
首藤	shou teng
首藤聪	shou teng cong
手冢	shou zhong
手冢国光	shou zhong guo guang
树希	shu xi
树希彦	shu xi yan
太一	tai yi
檀太一	tan tai yi
桃城	tao cheng
桃城武	tao cheng wu
天根	tian gen
天根光	tian gen guang
田仁志慧	tian ren zhi hui
拓也	tuo ye
丸井	wan jing
丸井文太	wan jing wen tai
文太	wen tai
喜多	xi duo
喜多一马	xi duo yi ma
夏乃	xia nai
夏乃佳	xia nai jia
弦一郎	xian yi lang
向日	xiang ri
向日岳人	xiang ri yue ren
小坂田朋香	xiao ban tian peng xiang
小石川健二郎	xiao shi chuan jian er lang
新渡米	xin du mi
新渡米稻吉	xin du mi dao ji
幸村	xing cun
幸村精市	xing cun jing shi
穴户	xue hu
穴户亮	xue hu liang
亚久津	ya jiu jin
亚久津仁	ya jiu jin ren
雅美	ya mei
雅也	ya ye
雅治	ya zhi
野村	ye cun
野村拓也	ye cun tuo ye
一郎	yi lang
一马	yi ma
一氏勇次	yi shi yong ci
伊武	yi wu
伊武深司	yi wu shen si
英二	ying er
樱井	ying jing
樱井雅也	ying jing ya ye
樱乃	ying nai
友惠	you hui
侑士	you shi
裕太	yu tai
远山金太郎	yuan shan jin tai lang
越前	yue qian
越前菜菜子	yue qian cai cai zi
越前龙马	yue qian long ma
越前伦子	yue qian lun zi
越前南次郎	yue qian nan ci lang
岳人	yue ren
真田	zhen tian
真田弦一郎	zhen tian xian yi lang
枝纯	zhi chun
知念宽	zhi nian kuan
智乡	zhi xiang
智乡木奈子	zhi xiang mu nai zi
中田	zhong tian
中田和菜	zhong tian he cai
周助	zhou zhu
佐伯	zuo bo
佐伯虎次郎	zuo bo hu ci lang